ZIP Code,Population Under 18 years (Selected),Total Population,Population Under 5 years,Population 5 to 9 years,Population 10 to 14 years,Population 15 to 19 years,Percent Population Under 5 years,Percent Population 5 to 9 years,Percent Population 10 to 14 years,Percent Population Under 18 years (Selected),Male Population Under 5 years,Male Population 5 to 9 years,Male Population 10 to 14 years,Female Population Under 5 years,Female Population 5 to 9 years,Female Population 10 to 14 years,Female Population Under 18 years (Selected)
89010,71,461,20,28,23,10,4.3,6.1,5.0,15.4,9,9,17,11,19,6,36
89019,146,2312,56,31,28,76,2.4,1.3,1.2,6.3,12,14,0,44,17,28,109
89060,1917,12198,509,662,372,510,4.2,5.4,3.0,15.7,174,153,104,335,509,268,1343
89061,971,7529,69,411,342,184,0.9,5.5,4.5,12.9,20,206,315,49,205,27,308
89439,192,1639,42,111,29,18,2.6,6.8,1.8,11.7,30,62,21,12,49,8,69
90001,17012,57652,4145,4620,5120,4820,7.2,8.0,8.9,29.5,1914,2405,2626,2231,2215,2494,8721
90002,15282,53108,3519,4341,4687,4533,6.6,8.2,8.8,28.8,1745,2179,2414,1774,2162,2273,7390
90003,23588,75024,5689,6484,7206,6378,7.6,8.6,9.6,31.4,2983,3544,4097,2706,2940,3109,10560
90004,10842,58833,3221,3287,2932,2533,5.5,5.6,5.0,18.4,1760,1732,1857,1461,1555,1075,4922
90005,6565,37754,1726,1786,2058,1669,4.6,4.7,5.5,17.4,832,1043,1056,894,743,1002,3074
90006,11210,56628,2494,3485,3274,3429,4.4,6.2,5.8,19.8,1047,1506,1793,1447,1979,1481,6064
90007,5377,41004,1339,1462,1547,4688,3.3,3.6,3.8,13.1,652,709,747,687,753,800,2723
90008,5777,33076,1544,1454,2076,1345,4.7,4.4,6.3,17.5,684,695,872,860,759,1204,3145
90010,180,4185,82,23,27,76,2.0,0.5,0.6,4.3,28,10,27,54,13,0,115
90011,30173,106042,6597,8186,9609,9271,6.2,7.7,9.1,28.5,3787,4175,5180,2810,4011,4429,14284
90012,3144,38430,983,775,745,1203,2.6,2.0,1.9,8.2,556,493,451,427,282,294,1186
90013,341,14587,66,103,105,92,0.5,0.7,0.7,2.3,0,38,105,66,65,0,183
90014,426,9273,152,101,146,163,1.6,1.1,1.6,4.6,74,75,111,78,26,35,139
90015,3477,25554,823,902,1115,1340,3.2,3.5,4.4,13.6,463,285,586,360,617,529,1750
90016,9984,47309,2251,2668,3383,2498,4.8,5.6,7.2,21.1,1328,1398,1924,923,1270,1459,4383
90017,5743,28754,1697,1409,1592,1668,5.9,4.9,5.5,20.0,905,791,894,792,618,698,2583
90018,10479,49898,2888,2692,3223,2840,5.8,5.4,6.5,21.0,1592,1623,1566,1296,1069,1657,4800
90019,10146,59410,2902,2246,3235,2640,4.9,3.8,5.4,17.1,1503,1127,1631,1399,1119,1604,4981
90020,6479,38400,1906,2062,1482,1780,5.0,5.4,3.9,16.9,1074,1047,704,832,1015,778,3120
90021,369,2781,58,185,38,138,2.1,6.7,1.4,13.3,18,123,38,40,62,0,172
90022,15403,64147,3679,4201,4455,4560,5.7,6.5,6.9,24.0,2149,2053,2507,1530,2148,1948,7296
90023,13155,44558,2691,3422,4376,3988,6.0,7.7,9.8,29.5,1469,1858,2359,1222,1564,2017,6235
90024,3407,50392,1146,997,687,10841,2.3,2.0,1.4,6.8,358,550,353,788,447,334,1927
90025,4744,44429,2100,987,1108,1218,4.7,2.2,2.5,10.7,1375,543,557,725,444,551,1909
90026,9862,64769,3289,2255,2566,3006,5.1,3.5,4.0,15.2,1905,906,1290,1384,1349,1276,4837
90027,5519,45764,2245,1655,1001,1059,4.9,3.6,2.2,12.1,1222,825,544,1023,830,457,2645
90028,2256,30982,395,797,686,862,1.3,2.6,2.2,7.3,126,284,213,269,513,473,1431
90029,5346,34649,1297,1244,1690,1607,3.7,3.6,4.9,15.4,649,643,812,648,601,878,2738
90031,7147,37457,2014,1479,2330,1991,5.4,3.9,6.2,19.1,936,793,1169,1078,686,1161,3516
90032,8955,44881,2401,2268,2827,2706,5.3,5.1,6.3,20.0,1487,1198,1671,914,1070,1156,3897
90033,12086,47655,2899,3334,3625,4081,6.1,7.0,7.6,25.4,1616,1683,1599,1283,1651,2026,5959
90034,7411,55061,2362,1918,2051,1837,4.3,3.5,3.7,13.5,1115,818,949,1247,1100,1102,3933
90035,5421,26595,1853,1438,1413,990,7.0,5.4,5.3,20.4,943,705,654,910,733,759,2723
90036,5389,37713,1615,1351,1658,1204,4.3,3.6,4.4,14.3,908,786,852,707,565,806,2344
90037,18249,69064,4551,5363,5486,4756,6.6,7.8,7.9,26.4,2234,2605,2614,2317,2758,2872,9249
90038,3527,27979,983,620,1114,1547,3.5,2.2,4.0,12.6,593,268,588,390,352,526,1645
90039,3674,28244,1118,1293,841,862,4.0,4.6,3.0,13.0,590,808,342,528,485,499,1701
90040,2510,11839,344,891,730,884,2.9,7.5,6.2,21.2,161,441,396,183,450,334,1285
90041,5107,28321,1714,1347,1233,1995,6.1,4.8,4.4,18.0,1189,717,642,525,630,591,2274
90042,10131,59151,3106,2587,2863,2716,5.3,4.4,4.8,17.1,1770,1229,1321,1336,1358,1542,5082
90043,8905,44461,1910,2608,2896,2587,4.3,5.9,6.5,20.0,1024,1217,1438,886,1391,1458,4374
90044,29348,98990,7202,8123,8644,8706,7.3,8.2,8.7,29.6,4083,4277,4588,3119,3846,4056,13922
90045,6206,41123,1953,1639,1437,3918,4.7,4.0,3.5,15.1,1036,837,804,917,802,633,2968
90046,3500,48170,1232,954,985,535,2.6,2.0,2.0,7.3,499,621,632,733,333,353,1621
90047,11834,52200,3063,3336,3589,2924,5.9,6.4,6.9,22.7,1569,1892,1989,1494,1444,1600,5327
90048,1840,20411,845,478,369,300,4.1,2.3,1.8,9.0,493,305,227,352,173,142,754
90049,6401,35819,1941,1681,1881,1420,5.4,4.7,5.3,17.9,1237,766,934,704,915,947,3055
90052,0,0,0,0,0,0,,,,,0,0,0,0,0,0,0
90056,1711,8225,420,467,646,311,5.1,5.7,7.9,20.8,221,133,425,199,334,221,833
90057,10044,47142,2537,3034,3017,2323,5.4,6.4,6.4,21.3,1213,1526,1411,1324,1508,1606,5146
90058,731,3049,220,212,138,240,7.2,7.0,4.5,24.0,139,143,38,81,69,100,321
90059,12445,39471,3374,3340,3883,3101,8.5,8.5,9.8,31.5,1886,1694,1760,1488,1646,2123,6061
90061,8031,28646,2134,2335,2407,1930,7.4,8.2,8.4,28.0,1250,1227,1099,884,1108,1308,3934
90062,7184,33528,1977,1768,1846,2389,5.9,5.3,5.5,21.4,901,856,881,1076,912,965,3584
90063,12316,52008,3020,2947,3700,4249,5.8,5.7,7.1,23.7,1553,1657,1985,1467,1290,1715,5877
90064,4765,25956,1526,1669,1028,734,5.9,6.4,4.0,18.4,712,931,572,814,738,456,2245
90065,7936,44897,2373,2494,1871,1966,5.3,5.6,4.2,17.7,1154,1406,958,1219,1088,913,3840
90066,8589,54142,2905,2222,2131,2368,5.4,4.1,3.9,15.9,1396,1195,1176,1509,1027,955,4229
90067,291,2653,80,76,115,20,3.0,2.9,4.3,11.0,48,30,38,32,46,77,155
90068,2216,21064,783,469,441,654,3.7,2.2,2.1,10.5,521,232,212,262,237,229,904
90069,1233,20045,577,244,306,176,2.9,1.2,1.5,6.2,283,163,181,294,81,125,544
90071,0,313,0,0,0,0,0.0,0.0,0.0,0.0,0,0,0,0,0,0,0
90073,0,1014,0,0,0,2,0.0,0.0,0.0,0.0,0,0,0,0,0,0,0
90077,1839,7868,388,510,482,658,4.9,6.5,6.1,23.4,241,228,173,147,282,309,997
90079,0,0,0,0,0,0,,,,,0,0,0,0,0,0,0
90089,90,4164,0,0,0,2567,0.0,0.0,0.0,2.2,0,0,0,0,0,0,68
90094,2470,11891,1314,704,276,210,11.1,5.9,2.3,20.8,461,252,115,853,452,161,1596
90095,0,0,0,0,0,0,,,,,0,0,0,0,0,0,0
90201,25850,95134,6261,6651,8285,8131,6.6,7.0,8.7,27.2,2896,3569,4314,3365,3082,3971,12706
90210,3513,19180,576,536,1291,1524,3.0,2.8,6.7,18.3,317,296,689,259,240,602,1643
90211,1825,9208,253,289,840,480,2.7,3.1,9.1,19.8,100,71,495,153,218,345,1025
90212,1443,10881,302,221,596,605,2.8,2.0,5.5,13.3,204,87,194,98,134,402,762
90220,14012,49101,3928,3790,4110,3499,8.0,7.7,8.4,28.5,1680,1858,2142,2248,1932,1968,7169
90221,14108,52119,3039,3363,4898,4569,5.8,6.5,9.4,27.1,1543,1593,2445,1496,1770,2453,6944
90222,9080,33021,2620,2583,2415,2362,7.9,7.8,7.3,27.5,1210,1330,1149,1410,1253,1266,4644
90230,6813,32005,2059,1954,2081,1012,6.4,6.1,6.5,21.3,1116,910,1236,943,1044,845,3190
90232,2926,16352,938,889,805,421,5.7,5.4,4.9,17.9,516,428,509,422,461,296,1328
90240,6036,26026,1506,1704,1723,1838,5.8,6.5,6.6,23.2,636,658,789,870,1046,934,3367
90241,10175,45341,2429,3231,2512,3222,5.4,7.1,5.5,22.4,1025,1704,1313,1404,1527,1199,5079
90242,9294,41685,1649,2389,3273,2967,4.0,5.7,7.9,22.3,945,1289,1470,704,1100,1803,4757
90245,3550,17081,701,1148,1225,634,4.1,6.7,7.2,20.8,278,575,605,423,573,620,1860
90247,9593,47682,2146,3157,2695,2781,4.5,6.6,5.7,20.1,1103,1564,1350,1043,1593,1345,4810
90248,1670,11453,649,371,421,545,5.7,3.2,3.7,14.6,275,100,144,374,271,277,1022
90249,5208,25929,1442,1609,1250,1435,5.6,6.2,4.8,20.1,432,864,646,1010,745,604,2669
90250,24046,96200,6420,6735,7001,6228,6.7,7.0,7.3,25.0,3641,3329,3862,2779,3406,3139,11494
90254,3779,19551,972,1183,915,966,5.0,6.1,4.7,19.3,581,544,433,391,639,482,1735
90255,17925,71654,4178,4503,5665,6240,5.8,6.3,7.9,25.0,1985,2334,3097,2193,2169,2568,8383
90260,7662,33282,1973,1783,2337,2295,5.9,5.4,7.0,23.0,945,903,974,1028,880,1363,3981
90262,17157,66073,4678,4732,5332,4346,7.1,7.2,8.1,26.0,2478,2360,3030,2200,2372,2302,7974
90263,14,1803,0,0,0,969,0.0,0.0,0.0,0.8,0,0,0,0,0,0,9
90265,3142,16652,520,661,1157,1232,3.1,4.0,6.9,18.9,339,404,655,181,257,502,1223
90266,9408,35123,1773,2795,2857,2503,5.0,8.0,8.1,26.8,952,1250,1568,821,1545,1289,4715
90270,6906,24950,1692,1827,2285,1899,6.8,7.3,9.2,27.7,770,898,1418,922,929,867,3166
90272,5562,21298,1376,1538,1732,1241,6.5,7.2,8.1,26.1,636,838,775,740,700,957,2867
90274,5487,24942,880,1735,1737,1754,3.5,7.0,7.0,22.0,467,537,995,413,1198,742,2824
90275,8779,41941,1917,2018,3008,2830,4.6,4.8,7.2,20.9,865,1066,1562,1052,952,1446,4192
90277,6939,36339,1824,1462,2472,1656,5.0,4.0,6.8,19.1,833,753,1140,991,709,1332,3555
90278,10659,42536,3591,3497,2312,1873,8.4,8.2,5.4,25.1,1835,1575,955,1756,1922,1357,5405
90280,22875,92262,5470,5604,7556,7058,5.9,6.1,8.2,24.8,3005,2922,3474,2465,2682,4082,11408
90290,1053,5300,289,265,182,423,5.5,5.0,3.4,19.9,140,95,72,149,170,110,547
90291,3181,25656,911,874,731,902,3.6,3.4,2.8,12.4,492,401,447,419,473,284,1477
90292,2988,24481,1559,709,438,350,6.4,2.9,1.8,12.2,617,490,241,942,219,197,1432
90293,1249,13039,388,453,331,145,3.0,3.5,2.5,9.6,239,273,211,149,180,120,481
90301,7690,37341,2159,2259,1915,2254,5.8,6.0,5.1,20.6,1055,1063,735,1104,1196,1180,3896
90302,6292,29307,1471,1514,2209,1742,5.0,5.2,7.5,21.5,856,763,966,615,751,1243,3131
90303,5733,23370,1516,1839,1608,1238,6.5,7.9,6.9,24.5,818,949,843,698,890,765,2688
90304,6369,25725,1530,1803,1988,1826,5.9,7.0,7.7,24.8,706,1171,1016,824,632,972,2943
90305,2380,14679,532,686,613,817,3.6,4.7,4.2,16.2,189,410,315,343,276,298,1263
90401,315,7480,57,167,62,85,0.8,2.2,0.8,4.2,9,131,54,48,36,8,101
90402,2785,11816,841,725,705,623,7.1,6.1,6.0,23.6,301,455,529,540,270,176,1279
90403,3179,24092,1005,1025,703,707,4.2,4.3,2.9,13.2,553,429,420,452,596,283,1501
90404,3985,23975,1018,1059,1341,1100,4.2,4.4,5.6,16.6,689,537,755,329,522,586,1776
90405,4012,26981,1461,942,947,1038,5.4,3.5,3.5,14.9,760,574,537,701,368,410,1681
90501,9646,42536,2697,2696,2644,2745,6.3,6.3,6.2,22.7,1558,1377,1250,1139,1319,1394,4740
90502,2926,18430,945,792,784,675,5.1,4.3,4.3,15.9,435,355,385,510,437,399,1506
90503,8876,44280,2238,2876,2499,1890,5.1,6.5,5.6,20.0,1325,1687,1277,913,1189,1222,3735
90504,6639,32965,1661,1761,2134,1683,5.0,5.3,6.5,20.1,815,857,1126,846,904,1008,3231
90505,8553,36214,1598,2624,2857,1898,4.4,7.2,7.9,23.6,596,1300,1434,1002,1324,1423,4335
90506,0,0,0,0,0,0,,,,,0,0,0,0,0,0,0
90601,6056,30667,1674,1649,1721,1762,5.5,5.4,5.6,19.7,732,731,942,942,918,779,3175
90602,6719,25949,1567,1890,1855,2260,6.0,7.3,7.1,25.9,874,880,1111,693,1010,744,3228
90603,4471,20883,1052,1215,1602,938,5.0,5.8,7.7,21.4,545,633,882,507,582,720,2099
90604,9684,39795,2267,2764,2831,2982,5.7,6.9,7.1,24.3,1073,1265,1541,1194,1499,1290,4848
90605,9459,41427,2488,2610,2945,2646,6.0,6.3,7.1,22.8,1259,1515,1365,1229,1095,1580,4465
90606,6891,31717,1731,2022,1869,2024,5.5,6.4,5.9,21.7,717,903,965,1014,1119,904,3510
90620,10230,47042,2738,2846,3283,2221,5.8,6.0,7.0,21.7,1403,1332,1882,1335,1514,1401,4823
90621,8012,36151,2046,2050,2868,1789,5.7,5.7,7.9,22.2,1001,989,1217,1045,1061,1651,4170
90623,2991,15419,637,825,831,1145,4.1,5.4,5.4,19.4,286,521,465,351,304,366,1356
90630,11656,50170,3065,3106,3542,3151,6.1,6.2,7.1,23.2,1442,1420,1702,1623,1686,1840,6158
90631,14887,69064,3884,3931,4280,4578,5.6,5.7,6.2,21.6,2200,2047,2489,1684,1884,1791,6753
90638,9128,46170,2000,2630,2890,2685,4.3,5.7,6.3,19.8,1194,1529,1376,806,1101,1514,4224
90639,19,1833,0,0,0,970,0.0,0.0,0.0,1.0,0,0,0,0,0,0,19
90640,13043,62294,3523,3556,3693,3652,5.7,5.7,5.9,20.9,1171,1749,2075,2352,1807,1618,6890
90650,23294,101983,7266,5923,6066,6737,7.1,5.8,5.9,22.8,3603,3005,3322,3663,2918,2744,11267
90660,12853,61561,2685,3502,3819,4368,4.4,5.7,6.2,20.9,1320,1830,1881,1365,1672,1938,6430
90670,3714,17556,1124,768,1247,1021,6.4,4.4,7.1,21.2,527,401,596,597,367,651,1988
90680,6961,31102,1521,1877,2587,1809,4.9,6.0,8.3,22.4,803,693,1261,718,1184,1326,3760
90701,3208,16237,821,742,1003,1115,5.1,4.6,6.2,19.8,318,344,583,503,398,420,1669
90703,9127,49334,2091,2484,2958,2444,4.2,5.0,6.0,18.5,1180,1628,1487,911,856,1471,3965
90704,820,3822,189,125,336,262,4.9,3.3,8.8,21.5,58,58,144,131,67,192,432
90706,18465,78352,4640,5220,5355,5249,5.9,6.7,6.8,23.6,2216,2404,2477,2424,2816,2878,9624
90710,6188,27517,1525,1804,1925,1644,5.5,6.6,7.0,22.5,768,694,991,757,1110,934,3298
90712,6917,31552,2176,1893,1720,1974,6.9,6.0,5.5,21.9,1188,1151,903,988,742,817,3207
90713,5603,28439,1829,1559,1520,1204,6.4,5.5,5.3,19.7,1098,870,729,731,689,791,2609
90715,4157,20949,984,1103,1396,1197,4.7,5.3,6.7,19.8,471,525,675,513,578,721,2136
90716,3574,13941,886,1115,981,1104,6.4,8.0,7.0,25.6,283,639,465,603,476,516,1897
90717,4361,21788,1411,1096,956,1381,6.5,5.0,4.4,20.0,589,709,483,822,387,473,2087
90720,5812,23673,1012,1654,2057,1557,4.3,7.0,8.7,24.6,560,762,1216,452,892,841,2718
90723,14273,53286,3169,3601,5056,4399,5.9,6.8,9.5,26.8,1669,1557,2757,1500,2044,2299,6840
90731,13715,63431,3241,4306,3986,3370,5.1,6.8,6.3,21.6,1908,2041,1771,1333,2265,2215,7065
90732,3917,22078,1151,874,1141,1266,5.2,4.0,5.2,17.7,493,633,475,658,241,666,1938
90740,3293,24604,689,959,975,970,2.8,3.9,4.0,13.4,348,509,546,341,450,429,1615
90742,27,469,5,0,10,30,1.1,0.0,2.1,5.8,5,0,10,0,0,0,12
90743,53,434,0,0,25,28,0.0,0.0,5.8,12.2,0,0,25,0,0,0,28
90744,15200,54277,3794,4392,4307,4134,7.0,8.1,7.9,28.0,2102,2339,2577,1692,2053,1730,6539
90745,11794,58735,2767,2705,3769,4344,4.7,4.6,6.4,20.1,1480,1377,1955,1287,1328,1814,5723
90746,4887,27643,864,1390,1637,1561,3.1,5.0,5.9,17.7,655,596,735,209,794,902,2469
90747,0,25,0,0,0,25,0.0,0.0,0.0,0.0,0,0,0,0,0,0,0
90755,2277,11764,766,494,761,462,6.5,4.2,6.5,19.4,538,282,334,228,212,427,1061
90802,5186,40012,1389,1111,1590,1832,3.5,2.8,4.0,13.0,605,651,854,784,460,736,2661
90803,3309,31659,1087,623,843,1410,3.4,2.0,2.7,10.5,582,287,397,505,336,446,1485
90804,6574,37299,2046,1675,1992,1931,5.5,4.5,5.3,17.6,966,941,1098,1080,734,894,3044
90805,24626,96515,6728,6345,6863,7666,7.0,6.6,7.1,25.5,3190,3243,4024,3538,3102,2839,12055
90806,9445,40688,2461,2622,2931,2541,6.0,6.4,7.2,23.2,1408,1694,1424,1053,928,1507,4104
90807,6452,33153,1569,1615,2135,1983,4.7,4.9,6.4,19.5,904,772,1117,665,843,1018,3061
90808,8805,39698,2092,2566,2748,2110,5.3,6.5,6.9,22.2,1014,1422,1620,1078,1144,1128,4062
90810,8040,36306,1633,2318,2384,2874,4.5,6.4,6.6,22.1,848,1130,1348,785,1188,1036,3809
90813,13633,53647,3175,3818,4355,4059,5.9,7.1,8.1,25.4,1548,1975,2519,1627,1843,1836,6563
90814,3814,20723,1308,1078,934,683,6.3,5.2,4.5,18.4,566,522,511,742,556,423,1944
90815,8301,42759,2467,1827,2629,3658,5.8,4.3,6.1,19.4,1284,1021,1290,1183,806,1339,3846
90822,0,125,0,0,0,0,0.0,0.0,0.0,0.0,0,0,0,0,0,0,0
90831,0,0,0,0,0,0,,,,,0,0,0,0,0,0,0
90840,0,0,0,0,0,0,,,,,0,0,0,0,0,0,0
91001,7394,36420,2012,1953,2304,1735,5.5,5.4,6.3,20.3,990,868,1213,1022,1085,1091,3863
91006,6789,31986,1270,2014,2376,1640,4.0,6.3,7.4,21.2,538,1046,1007,732,968,1369,3610
91007,6498,33367,1407,1577,2487,1824,4.2,4.7,7.5,19.5,557,725,1277,850,852,1210,3447
91008,90,744,28,29,27,22,3.8,3.9,3.6,12.1,6,17,16,22,12,11,46
91010,4747,26825,1321,1132,1408,1432,4.9,4.2,5.2,17.7,824,662,876,497,470,532,1973
91011,5674,20389,910,1332,2102,1728,4.5,6.5,10.3,27.8,346,713,989,564,619,1113,2982
91016,9276,41822,2322,2429,2914,2482,5.6,5.8,7.0,22.2,1204,1354,1477,1118,1075,1437,4261
91020,1843,7509,365,414,814,411,4.9,5.5,10.8,24.5,132,242,433,233,172,381,987
91024,2033,11151,543,565,631,390,4.9,5.1,5.7,18.2,334,289,233,209,276,398,1000
91030,6136,26583,1557,1742,1921,1326,5.9,6.6,7.2,23.1,936,926,1023,621,816,898,2804
91040,3853,20911,1152,944,1156,780,5.5,4.5,5.5,18.4,661,500,603,491,444,553,1771
91042,4455,27119,1081,1260,1399,1282,4.0,4.6,5.2,16.4,519,607,555,562,653,844,2355
91046,0,141,0,0,0,0,0.0,0.0,0.0,0.0,0,0,0,0,0,0,0
91101,2037,19737,794,410,541,538,4.0,2.1,2.7,10.3,388,167,316,406,243,225,966
91103,5747,27167,1296,1271,2032,1544,4.8,4.7,7.5,21.2,799,576,1081,497,695,951,2683
91104,7013,35918,1648,1945,2399,1893,4.6,5.4,6.7,19.5,931,945,1264,717,1000,1135,3242
91105,1977,12692,657,527,552,365,5.2,4.2,4.3,15.6,283,364,311,374,163,241,890
91106,3751,23813,1448,912,839,1004,6.1,3.8,3.5,15.8,605,557,416,843,355,423,1935
91107,5984,32581,2076,1725,1477,1207,6.4,5.3,4.5,18.4,1011,772,858,1065,953,619,2973
91108,2894,12559,587,790,700,954,4.7,6.3,5.6,23.0,203,559,419,384,231,281,1318
91125,3,996,0,0,0,341,0.0,0.0,0.0,0.3,0,0,0,0,0,0,0
91201,4162,22163,906,1183,1517,1183,4.1,5.3,6.8,18.8,474,455,709,432,728,808,2308
91202,3634,22831,1029,1087,906,995,4.5,4.8,4.0,15.9,488,539,499,541,548,407,1846
91203,2735,16679,636,787,791,696,3.8,4.7,4.7,16.4,343,411,426,293,376,365,1225
91204,3127,18445,857,812,774,1092,4.6,4.4,4.2,17.0,401,353,387,456,459,387,1595
91205,6245,35755,1722,1679,1765,1798,4.8,4.7,4.9,17.5,603,844,823,1119,835,942,3419
91206,5259,32294,1729,1160,1578,1207,5.4,3.6,4.9,16.3,968,463,826,761,697,752,2535
91207,2130,11091,724,394,524,770,6.5,3.6,4.7,19.2,446,188,311,278,206,213,972
91208,2828,15377,552,636,906,1330,3.6,4.1,5.9,18.4,332,305,419,220,331,487,1641
91210,35,310,21,7,7,12,6.8,2.3,2.3,11.3,21,7,7,0,0,0,0
91214,8071,32344,1935,2458,2314,2067,6.0,7.6,7.2,25.0,1089,1208,1306,846,1250,1008,3734
91301,5923,25244,964,1630,2037,1907,3.8,6.5,8.1,23.5,615,931,885,349,699,1152,2752
91302,5706,26318,1052,1417,2025,1775,4.0,5.4,7.7,21.7,512,706,1064,540,711,961,2928
91303,6392,30611,1882,1636,2054,1587,6.1,5.3,6.7,20.9,955,736,1163,927,900,891,3111
91304,11244,54369,2779,3136,3171,3610,5.1,5.8,5.8,20.7,1354,1727,1468,1425,1409,1703,5613
91306,10778,49460,3192,2933,2896,3021,6.5,5.9,5.9,21.8,1655,1444,1684,1537,1489,1212,5031
91307,5395,25368,1382,1571,1464,1761,5.4,6.2,5.8,21.3,686,723,673,696,848,791,2912
91311,7921,40196,2206,2186,1843,2346,5.5,5.4,4.6,19.7,967,977,1147,1239,1209,696,3937
91316,5371,28497,1693,1487,1556,1007,5.9,5.2,5.5,18.8,662,817,629,1031,670,927,3033
91320,10299,44138,2429,2696,3163,3211,5.5,6.1,7.2,23.3,1194,1281,1758,1235,1415,1405,5044
91321,8885,34305,2595,2203,2532,2753,7.6,6.4,7.4,25.9,1036,825,1269,1559,1378,1263,5204
91324,5744,29744,1757,1370,1751,1583,5.9,4.6,5.9,19.3,1059,900,847,698,470,904,2506
91325,6264,35537,1306,1678,2150,2136,3.7,4.7,6.1,17.6,499,881,856,807,797,1294,3386
91326,7655,36503,1777,2100,2231,2414,4.9,5.8,6.1,21.0,896,1126,1187,881,974,1044,3721
91330,30,2699,0,0,0,1515,0.0,0.0,0.0,1.1,0,0,0,0,0,0,19
91331,24450,99804,5650,6872,7365,7465,5.7,6.9,7.4,24.5,2736,3546,3775,2914,3326,3590,11844
91335,16435,77158,4409,4159,5080,4913,5.7,5.4,6.6,21.3,2394,1981,2701,2015,2178,2379,8066
91340,8081,34822,1987,2160,2632,2331,5.7,6.2,7.6,23.2,985,1117,1466,1002,1043,1166,3949
91342,20896,92580,5357,5098,6177,7175,5.8,5.5,6.7,22.6,2999,2652,3447,2358,2446,2730,9523
91343,15378,63193,4038,4019,4173,4931,6.4,6.4,6.6,24.3,1996,2017,2352,2042,2002,1821,7549
91344,10828,53862,2975,2741,3236,2932,5.5,5.1,6.0,20.1,1649,1382,1683,1326,1359,1553,5138
91345,3278,18481,942,944,694,1104,5.1,5.1,3.8,17.7,382,447,385,560,497,309,1719
91350,12160,42970,2574,3240,4005,3078,6.0,7.5,9.3,28.3,1345,1739,1949,1229,1501,2056,5952
91351,7827,32677,2297,1699,2490,1923,7.0,5.2,7.6,24.0,1562,835,1472,735,864,1018,3457
91352,9628,45601,2021,2845,3008,3148,4.4,6.2,6.6,21.1,881,1411,1395,1140,1434,1613,5064
91354,8574,33039,1823,2533,2719,2245,5.5,7.7,8.2,26.0,800,1291,1224,1023,1242,1495,4492
91355,5668,30289,1900,1278,1699,1786,6.3,4.2,5.6,18.7,917,728,944,983,550,755,2630
91356,5851,30599,1134,1635,1936,1930,3.7,5.3,6.3,19.1,481,874,1077,653,761,859,2755
91360,7860,42444,1979,2008,2369,2763,4.7,4.7,5.6,18.5,1198,1053,1189,781,955,1180,3538
91361,3432,18753,846,899,995,911,4.5,4.8,5.3,18.3,500,494,583,346,405,412,1421
91362,7123,36770,1584,2143,2200,1833,4.3,5.8,6.0,19.4,654,1205,1299,930,938,901,3216
91364,6567,28765,2227,1722,1644,1168,7.7,6.0,5.7,22.8,939,798,1031,1288,924,613,3306
91367,8049,44862,2390,1825,1979,2539,5.3,4.1,4.4,17.9,1035,1174,1169,1355,651,810,3671
91371,0,0,0,0,0,0,,,,,0,0,0,0,0,0,0
91377,3423,13627,810,630,1215,1021,5.9,4.6,8.9,25.1,411,360,672,399,270,543,1605
91381,5578,20864,1115,1430,1652,1935,5.3,6.9,7.9,26.7,661,622,527,454,808,1125,3350
91384,6449,27652,1526,1713,2073,1803,5.5,6.2,7.5,23.3,938,954,823,588,759,1250,3121
91387,12666,46812,3609,3112,3959,3577,7.7,6.6,8.5,27.1,2020,1606,2210,1589,1506,1749,5883
91390,4368,18930,749,1106,1428,1316,4.0,5.8,7.5,23.1,277,599,693,472,507,735,2377
91401,7474,39179,2373,1797,2098,1956,6.1,4.6,5.4,19.1,1116,882,1212,1257,915,886,3531
91402,16688,67937,4066,4797,5102,4454,6.0,7.1,7.5,24.6,2170,2323,2823,1896,2474,2279,7788
91403,4306,25887,1512,959,1146,943,5.8,3.7,4.4,16.6,974,614,598,538,345,548,1719
91405,12361,55451,3131,3342,3733,3660,5.6,6.0,6.7,22.3,1698,1592,2071,1433,1750,1662,6146
91406,12035,53276,3399,2956,3572,3308,6.4,5.5,6.7,22.6,1808,1622,1759,1591,1334,1813,5953
91411,4664,23689,1419,1250,1269,1084,6.0,5.3,5.4,19.7,835,561,696,584,689,573,2186
91423,4991,31787,1634,1256,1172,1290,5.1,4.0,3.7,15.7,879,797,473,755,459,699,2405
91436,3479,16190,961,1113,867,979,5.9,6.9,5.4,21.5,389,750,394,572,363,473,1644
91501,3256,18951,819,1057,957,919,4.3,5.6,5.0,17.2,482,582,542,337,475,415,1420
91502,2067,12312,654,467,595,627,5.3,3.8,4.8,16.8,309,269,244,345,198,351,1059
91504,5789,27479,1484,2035,1427,1342,5.4,7.4,5.2,21.1,723,1175,878,761,860,549,2682
91505,6350,32156,1691,1597,1903,1916,5.3,5.0,5.9,19.7,860,729,857,831,868,1046,3273
91506,3387,19559,554,1182,982,1015,2.8,6.0,5.0,17.3,341,723,399,213,459,583,1553
91601,4630,35615,1445,1172,1149,1345,4.1,3.3,3.2,13.0,780,667,610,665,505,539,2229
91602,2432,19980,862,671,534,601,4.3,3.4,2.7,12.2,379,410,415,483,261,119,1072
91604,5480,32073,1761,1494,1401,1217,5.5,4.7,4.4,17.1,925,647,703,836,847,698,2792
91605,10529,51654,2371,3106,3175,3378,4.6,6.0,6.1,20.4,1384,1662,1469,987,1444,1706,5109
91606,8277,43552,2239,2091,2728,2273,5.1,4.8,6.3,19.0,1078,1167,1556,1161,924,1172,3811
91607,5192,30734,1302,1617,1691,885,4.2,5.3,5.5,16.9,648,901,674,654,716,1017,2737
91608,0,56,0,0,0,0,0.0,0.0,0.0,0.0,0,0,0,0,0,0,0
91701,7922,39323,1987,1762,2539,2727,5.1,4.5,6.5,20.1,1237,891,1128,750,871,1411,3656
91702,12966,62196,3216,3565,4198,4670,5.2,5.7,6.7,20.8,1612,1952,2147,1604,1613,2051,6292
91706,15377,72495,3814,3793,4965,5257,5.3,5.2,6.8,21.2,1769,1950,2512,2045,1843,2453,7647
91708,4704,15908,1546,1262,1611,340,9.7,7.9,10.1,29.6,814,486,901,732,776,710,2343
91709,17346,78341,4738,4213,5207,4949,6.0,5.4,6.6,22.1,2348,2349,2901,2390,1864,2306,7731
91710,17768,81466,4510,4806,4970,4959,5.5,5.9,6.1,21.8,2636,2199,2624,1874,2607,2346,8428
91711,6245,37542,1288,1591,2118,4160,3.4,4.2,5.6,16.6,713,639,1050,575,952,1068,3222
91722,7118,34470,1995,1873,2064,2085,5.8,5.4,6.0,20.6,926,919,1259,1069,954,805,3303
91723,3651,17964,969,639,1037,1471,5.4,3.6,5.8,20.3,519,446,441,450,193,596,1752
91724,5889,28575,1373,1982,1761,1374,4.8,6.9,6.2,20.6,702,1197,859,671,785,902,2731
91730,16581,71040,5706,4043,4385,4366,8.0,5.7,6.2,23.3,2783,1909,2294,2923,2134,2091,8538
91731,6486,28201,1887,1850,1431,1989,6.7,6.6,5.1,23.0,1087,991,728,800,859,703,2946
91732,13197,58888,3385,3225,4302,4028,5.7,5.5,7.3,22.4,1898,1425,2127,1487,1800,2175,6696
91733,9696,42953,2541,1948,3048,3130,5.9,4.5,7.1,22.6,1366,986,1673,1175,962,1375,4493
91737,5043,23108,1306,1031,1733,1500,5.7,4.5,7.5,21.8,767,646,909,539,385,824,2179
91739,10068,41319,2511,3012,3048,2551,6.1,7.3,7.4,24.4,1444,1744,1792,1067,1268,1256,4321
91740,6196,27131,1431,1671,1928,1652,5.3,6.2,7.1,22.8,732,744,725,699,927,1203,3408
91741,5693,26052,1140,1477,1938,1780,4.4,5.7,7.4,21.9,592,812,814,548,665,1124,2816
91744,17843,79380,3572,4733,6008,6067,4.5,6.0,7.6,22.5,1757,2750,3238,1815,1983,2770,8220
91745,10417,55489,2758,2972,2947,3321,5.0,5.4,5.3,18.8,1139,1388,1391,1619,1584,1556,5499
91746,6037,29429,1512,1359,2105,1986,5.1,4.6,7.2,20.5,805,471,1229,707,888,876,3101
91748,7960,43851,2295,1965,2237,2319,5.2,4.5,5.1,18.2,1237,1056,1102,1058,909,1135,3801
91750,6574,33436,1272,1632,2336,2270,3.8,4.9,7.0,19.7,674,835,1143,598,797,1193,3169
91752,8960,37173,2331,2394,2541,2720,6.3,6.4,6.8,24.1,1139,741,1359,1192,1653,1182,4756
91754,5908,33937,1282,1821,1678,1825,3.8,5.4,4.9,17.4,529,930,880,753,891,798,3017
91755,4479,26418,964,1356,1162,1514,3.6,5.1,4.4,17.0,530,756,523,434,600,639,2170
91759,36,299,7,13,8,8,2.3,4.3,2.7,12.0,0,13,4,7,0,4,15
91761,14878,61837,4001,3929,4159,4588,6.5,6.4,6.7,24.1,1880,1709,2171,2121,2220,1988,7893
91762,16006,62990,4750,4632,4669,3635,7.5,7.4,7.4,25.4,2563,2219,2279,2187,2413,2390,7942
91763,9570,37698,2385,2235,3088,2888,6.3,5.9,8.2,25.4,972,990,1699,1413,1245,1389,5068
91764,13782,55311,2996,3838,3876,4769,5.4,6.9,7.0,24.9,1343,1962,1813,1653,1876,2063,7022
91765,8805,45303,1938,2068,3064,2886,4.3,4.6,6.8,19.4,1105,959,1472,833,1109,1592,4474
91766,17123,69517,3946,4226,5383,6196,5.7,6.1,7.7,24.6,2100,2006,2606,1846,2220,2777,8697
91767,12372,50715,3549,3373,3268,3644,7.0,6.7,6.4,24.4,1720,1914,1553,1829,1459,1715,6344
91768,7804,35443,2306,1866,2522,3638,6.5,5.3,7.1,22.0,1132,898,1162,1174,968,1360,4187
91770,11041,59410,2883,2236,3260,3940,4.9,3.8,5.5,18.6,1375,1285,1612,1508,951,1648,4985
91773,6833,34066,1745,1859,2094,1915,5.1,5.5,6.1,20.1,982,902,903,763,957,1191,3513
91775,4697,24169,1352,1008,1397,1479,5.6,4.2,5.8,19.4,713,454,796,639,554,601,2168
91776,6580,37340,1876,1494,1905,1845,5.0,4.0,5.1,17.6,995,712,1307,881,782,598,2899
91780,7577,35556,1851,2023,2409,2109,5.2,5.7,6.8,21.3,999,961,1148,852,1062,1261,3878
91784,5062,26116,1108,1274,1627,1639,4.2,4.9,6.2,19.4,454,541,827,654,733,800,2762
91786,12589,56025,3681,3011,3780,3234,6.6,5.4,6.7,22.5,1914,1462,1854,1767,1549,1926,6437
91789,7779,41377,1798,2073,2612,1999,4.3,5.0,6.3,18.8,807,980,1305,991,1093,1307,4124
91790,9802,44855,2078,3020,2968,2751,4.6,6.7,6.6,21.9,1150,1681,1467,928,1339,1501,4683
91791,6011,33902,1382,1649,1878,1823,4.1,4.9,5.5,17.7,799,900,786,583,749,1092,2852
91792,5781,31208,1600,1603,1663,1662,5.1,5.1,5.3,18.5,874,607,891,726,996,772,2948
91801,8984,53320,2618,2523,2243,2288,4.9,4.7,4.2,16.8,1331,1253,973,1287,1270,1270,4655
91803,5619,29006,1421,1447,1662,1527,4.9,5.0,5.7,19.4,723,754,831,698,693,831,2739
91901,3982,18669,949,1110,1232,1182,5.1,5.9,6.6,21.3,568,449,550,381,661,682,2136
91902,2860,17121,652,956,776,677,3.8,5.6,4.5,16.7,390,384,458,262,572,318,1428
91905,101,1411,40,24,25,14,2.8,1.7,1.8,7.2,15,9,23,25,15,2,54
91906,1370,4281,374,264,502,283,8.7,6.2,11.7,32.0,176,133,290,198,131,212,549
91910,16142,76313,3888,4153,4701,5422,5.1,5.4,6.2,21.2,1843,2107,2223,2045,2046,2478,8175
91911,21272,87799,5610,5646,6196,5786,6.4,6.4,7.1,24.2,2929,2756,2981,2681,2890,3215,10800
91913,15361,56102,2688,4971,5227,4275,4.8,8.9,9.3,27.4,1364,2208,2348,1324,2763,2879,8099
91914,4256,17373,937,1258,1157,1479,5.4,7.2,6.7,24.5,629,687,555,308,571,602,1843
91915,10966,35608,2637,3047,3322,2927,7.4,8.6,9.3,30.8,1621,1899,1303,1016,1148,2019,5110
91916,338,1833,64,141,99,41,3.5,7.7,5.4,18.4,20,64,66,44,77,33,154
91917,351,851,0,119,149,83,0.0,14.0,17.5,41.2,0,24,74,0,95,75,226
91931,241,749,32,75,134,0,4.3,10.0,17.9,32.2,0,38,31,32,37,103,172
91932,5846,26157,1839,1537,1629,2136,7.0,5.9,6.2,22.3,1002,713,845,837,824,784,2807
91934,118,1251,35,25,25,33,2.8,2.0,2.0,9.4,23,25,0,12,0,25,37
91935,1869,9320,633,473,477,473,6.8,5.1,5.1,20.1,366,228,258,267,245,219,908
91941,6738,33602,1902,1853,1769,1803,5.7,5.5,5.3,20.1,1137,1016,875,765,837,894,3127
91942,8475,40995,2948,1936,2388,1886,7.2,4.7,5.8,20.7,1319,1057,1229,1629,879,1159,4185
91945,6018,27541,1480,1611,1677,1886,5.4,5.8,6.1,21.9,855,680,931,625,931,746,2918
91948,0,104,0,0,0,0,0.0,0.0,0.0,0.0,0,0,0,0,0,0,0
91950,13018,57844,3188,3336,4358,3657,5.5,5.8,7.5,22.5,1584,1835,2162,1604,1501,2196,6416
91962,417,2528,147,100,169,18,5.8,4.0,6.7,16.5,56,69,90,91,31,79,202
91963,156,624,52,67,15,62,8.3,10.7,2.4,25.0,25,15,15,27,52,0,79
91977,16264,65497,4315,4182,4943,4514,6.6,6.4,7.5,24.8,2219,2215,2522,2096,1967,2421,8064
91978,2542,11006,1100,532,530,696,10.0,4.8,4.8,23.1,493,347,141,607,185,389,1396
91980,17,103,0,0,0,17,0.0,0.0,0.0,16.5,0,0,0,0,0,0,0
92003,767,4404,182,233,156,338,4.1,5.3,3.5,17.4,120,132,73,62,101,83,381
92004,344,3200,170,0,105,171,5.3,0.0,3.3,10.8,52,0,105,118,0,0,168
92007,3071,11939,1198,679,773,541,10.0,5.7,6.5,25.7,720,451,560,478,228,213,1023
92008,4453,27373,901,1472,1242,1443,3.3,5.4,4.5,16.3,469,900,713,432,572,529,2023
92009,12293,46334,2165,2622,4651,3607,4.7,5.7,10.0,26.5,1107,1254,2274,1058,1368,2377,6025
92010,3682,16566,712,872,1310,1126,4.3,5.3,7.9,22.2,392,520,759,320,352,551,1529
92011,5682,24472,907,1795,1848,1708,3.7,7.3,7.6,23.2,460,934,984,447,861,864,2730
92014,2029,12532,506,349,753,590,4.0,2.8,6.0,16.2,341,296,389,165,53,364,748
92019,10482,45937,2529,2661,3367,3016,5.5,5.8,7.3,22.8,1455,1525,1984,1074,1136,1383,4877
92020,14033,59775,4118,4134,3679,3509,6.9,6.9,6.2,23.5,1972,1880,2054,2146,2254,1625,7283
92021,17270,69638,4367,4597,5626,4770,6.3,6.6,8.1,24.8,2015,2299,2699,2352,2298,2927,8576
92024,9894,50222,2226,2543,3226,3018,4.4,5.1,6.4,19.7,1118,1069,1629,1108,1474,1597,5159
92025,12109,50270,3022,3156,3763,3256,6.0,6.3,7.5,24.1,1508,1515,1709,1514,1641,2054,6237
92026,11254,53053,3860,2838,2930,2635,7.3,5.3,5.5,21.2,2457,1402,1830,1403,1436,1100,4645
92027,13069,55750,3363,3923,3607,3816,6.0,7.0,6.5,23.4,1681,1701,1969,1682,2222,1638,6554
92028,12453,51135,3745,3140,3632,2949,7.3,6.1,7.1,24.4,1597,1733,2068,2148,1407,1564,6004
92029,3898,19986,1343,895,1036,843,6.7,4.5,5.2,19.5,632,450,476,711,445,560,1987
92036,281,3075,136,43,83,66,4.4,1.4,2.7,9.1,80,13,45,56,30,38,124
92037,6225,37665,1594,1763,1617,2243,4.2,4.7,4.3,16.5,1043,1143,724,551,620,893,2585
92040,10332,45906,2732,2763,2845,2977,6.0,6.0,6.2,22.5,1449,1088,1004,1283,1675,1841,5739
92054,6901,37050,1931,1699,2212,1641,5.2,4.6,6.0,18.6,1073,781,1124,858,918,1088,3325
92055,0,10618,0,0,0,2429,0.0,0.0,0.0,0.0,0,0,0,0,0,0,0
92056,11634,54190,3883,2875,3286,2482,7.2,5.3,6.1,21.5,2162,1434,1705,1721,1441,1581,5597
92057,13080,58022,2821,3846,4017,3835,4.9,6.6,6.9,22.5,1453,2067,1717,1368,1779,2300,6634
92058,12414,48272,4702,3676,2998,2970,9.7,7.6,6.2,25.7,2269,2110,1200,2433,1566,1798,6314
92059,477,1456,145,96,176,82,10.0,6.6,12.1,32.8,45,30,61,100,66,115,327
92060,0,506,0,0,0,0,0.0,0.0,0.0,0.0,0,0,0,0,0,0,0
92061,186,1677,39,38,60,119,2.3,2.3,3.6,11.1,18,16,14,21,22,46,120
92064,10841,48783,2825,3507,2957,2789,5.8,7.2,6.1,22.2,1606,1874,1525,1219,1633,1432,5138
92065,8103,36836,2030,2049,2641,2524,5.5,5.6,7.2,22.0,1345,1247,1561,685,802,1080,3546
92066,42,319,0,0,28,20,0.0,0.0,8.8,13.2,0,0,15,0,0,13,27
92067,2250,9186,517,777,727,477,5.6,8.5,7.9,24.5,91,286,352,426,491,375,1415
92069,11473,46648,3221,3094,3201,3400,6.9,6.6,6.9,24.6,1892,1586,1494,1329,1508,1707,5492
92070,120,761,27,22,46,31,3.5,2.9,6.0,15.8,15,19,38,12,3,8,39
92071,13657,59795,4422,3642,3472,3440,7.4,6.1,5.8,22.8,2552,1854,1856,1870,1788,1616,6152
92075,2372,12072,540,720,773,478,4.5,6.0,6.4,19.6,285,282,418,255,438,355,1233
92078,13566,53019,3473,4224,3931,4337,6.6,8.0,7.4,25.6,2008,2124,2307,1465,2100,1624,6200
92081,6494,29475,1939,1529,1794,1865,6.6,5.2,6.1,22.0,708,687,1236,1231,842,558,3327
92082,4830,20678,1380,1180,1463,1337,6.7,5.7,7.1,23.4,725,598,685,655,582,778,2422
92083,9225,37864,2776,2159,2584,2638,7.3,5.7,6.8,24.4,1307,928,1344,1469,1231,1240,4677
92084,12046,49971,3364,3155,3392,3758,6.7,6.3,6.8,24.1,1953,1629,1840,1411,1526,1552,5346
92086,163,1409,36,35,72,47,2.6,2.5,5.1,11.6,7,6,29,29,29,43,111
92091,211,1288,52,90,61,8,4.0,7.0,4.7,16.4,0,78,24,52,12,37,109
92092,0,521,0,0,0,386,0.0,0.0,0.0,0.0,0,0,0,0,0,0,0
92093,0,2044,0,0,0,1511,0.0,0.0,0.0,0.0,0,0,0,0,0,0,0
92096,0,0,0,0,0,0,,,,,0,0,0,0,0,0,0
92101,2090,46025,976,411,435,611,2.1,0.9,0.9,4.5,509,221,248,467,190,187,966
92102,8476,40051,2410,1860,3037,1921,6.0,4.6,7.6,21.2,1004,1020,1564,1406,840,1473,4201
92103,2979,34296,1034,702,865,666,3.0,2.0,2.5,8.7,499,288,511,535,414,354,1502
92104,6694,46613,2175,1927,1682,1391,4.7,4.1,3.6,14.4,1137,810,761,1038,1117,921,3484
92105,17282,72688,3870,4980,5079,5454,5.3,6.9,7.0,23.8,2019,2626,2709,1851,2354,2370,8380
92106,3796,20483,1382,988,953,1627,6.7,4.8,4.7,18.5,665,424,533,717,564,420,2078
92107,4158,29435,1785,902,919,1343,6.1,3.1,3.1,14.1,674,529,552,1111,373,367,2142
92108,2842,24201,1283,618,583,600,5.3,2.6,2.4,11.7,795,279,325,488,339,258,1189
92109,4528,44009,1661,1239,928,965,3.8,2.8,2.1,10.3,741,696,483,920,543,445,2118
92110,4526,30773,1468,1444,1029,2838,4.8,4.7,3.3,14.7,708,861,425,760,583,604,2225
92111,8256,47710,2113,2803,1828,3288,4.4,5.9,3.8,17.3,951,1294,990,1162,1509,838,4385
92113,14147,50983,3572,3805,4312,3848,7.0,7.5,8.5,27.7,1851,1836,2387,1721,1969,1925,6889
92114,14051,66487,3361,4162,4258,4285,5.1,6.3,6.4,21.1,1853,2451,2295,1508,1711,1963,6214
92115,10454,61456,3995,2599,2488,6788,6.5,4.2,4.0,17.0,1920,1527,1410,2075,1072,1078,5116
92116,3581,31836,1281,830,963,791,4.0,2.6,3.0,11.2,661,457,386,620,373,577,1745
92117,9556,54499,2719,2084,2909,3091,5.0,3.8,5.3,17.5,1561,1195,1442,1158,889,1467,4277
92118,3259,17602,636,842,1156,1153,3.6,4.8,6.6,18.5,293,524,611,343,318,545,1596
92119,5004,24419,1386,1514,1385,1124,5.7,6.2,5.7,20.5,490,802,752,896,712,633,2616
92120,6267,30241,1940,1777,1485,1826,6.4,5.9,4.9,20.7,832,1171,734,1108,606,751,2978
92121,613,4150,300,189,101,71,7.2,4.6,2.4,14.8,111,111,32,189,78,69,336
92122,6054,45988,1914,1548,1557,2543,4.2,3.4,3.4,13.2,1056,786,828,858,762,729,2734
92123,5933,32951,1912,1802,1392,1731,5.8,5.5,4.2,18.0,1036,979,815,876,823,577,2637
92124,8543,31121,3327,2575,1912,1293,10.7,8.3,6.1,27.5,1385,1513,916,1942,1062,996,4352
92126,15401,78111,5718,4478,3476,3304,7.3,5.7,4.5,19.7,2788,2188,1851,2930,2290,1625,7586
92127,14428,51107,4269,3999,4198,2950,8.4,7.8,8.2,28.2,2114,1885,2267,2155,2114,1931,7039
92128,9413,49273,2440,2536,3030,2396,5.0,5.1,6.1,19.1,1104,1559,1487,1336,977,1543,4499
92129,12267,52495,3089,3337,3666,3845,5.9,6.4,7.0,23.4,1554,1498,2003,1535,1839,1663,6155
92130,15484,57363,2862,4239,5227,4655,5.0,7.4,9.1,27.0,1382,2215,2651,1480,2024,2576,7608
92131,9365,35227,2068,2450,2864,2678,5.9,7.0,8.1,26.6,950,1303,1567,1118,1147,1297,4472
92132,0,0,0,0,0,0,,,,,0,0,0,0,0,0,0
92134,0,241,0,0,0,54,0.0,0.0,0.0,0.0,0,0,0,0,0,0,0
92135,0,1095,0,0,0,169,0.0,0.0,0.0,0.0,0,0,0,0,0,0,0
92136,6,9630,0,0,0,929,0.0,0.0,0.0,0.1,0,0,0,0,0,0,0
92139,7862,34930,1826,2510,2233,2518,5.2,7.2,6.4,22.5,782,1125,1213,1044,1385,1020,4160
92140,30,2807,0,0,0,1438,0.0,0.0,0.0,1.1,0,0,0,0,0,0,0
92145,0,2810,0,0,0,753,0.0,0.0,0.0,0.0,0,0,0,0,0,0,0
92147,0,180,0,0,0,26,0.0,0.0,0.0,0.0,0,0,0,0,0,0,0
92154,19045,83758,4187,4271,6432,6632,5.0,5.1,7.7,22.7,2437,2351,3090,1750,1920,3342,8979
92155,0,196,0,0,0,7,0.0,0.0,0.0,0.0,0,0,0,0,0,0,0
92161,0,12,0,0,0,0,0.0,0.0,0.0,0.0,0,0,0,0,0,0,0
92173,7195,28609,2005,1953,2070,2018,7.0,6.8,7.2,25.1,954,1184,961,1051,769,1109,3591
92179,0,3031,0,0,0,2,0.0,0.0,0.0,0.0,0,0,0,0,0,0,0
92182,0,0,0,0,0,0,,,,,0,0,0,0,0,0,0
92201,13834,64325,3240,3448,3921,4894,5.0,5.4,6.1,21.5,1910,1975,1482,1330,1473,2439,6919
92203,8130,33558,1693,2491,2356,2439,5.0,7.4,7.0,24.2,683,1309,1291,1010,1182,1065,4062
92210,286,4832,80,104,34,88,1.7,2.2,0.7,5.9,48,101,16,32,3,18,83
92211,3129,26741,779,1117,829,638,2.9,4.2,3.1,11.7,278,806,264,501,311,565,1700
92220,7503,32797,1967,2020,2345,1796,6.0,6.2,7.2,22.9,1080,1207,1227,887,813,1118,3342
92222,0,0,0,0,0,0,,,,,0,0,0,0,0,0,0
92223,17554,61686,4958,4647,5423,3925,8.0,7.5,8.8,28.5,2589,2468,2767,2369,2179,2656,8262
92225,4610,21189,1411,1167,1114,1370,6.7,5.5,5.3,21.8,837,470,524,574,697,590,2234
92227,8222,27540,2510,2324,2048,2058,9.1,8.4,7.4,29.9,1243,1313,1070,1267,1011,978,4101
92230,343,2039,178,20,134,11,8.7,1.0,6.6,16.8,90,20,47,88,0,87,176
92231,11135,38674,2814,2868,3689,3052,7.3,7.4,9.5,28.8,1481,1482,1738,1333,1386,1951,5300
92233,1109,6871,227,196,466,338,3.3,2.9,6.8,16.1,102,85,242,125,111,224,575
92234,10485,51964,2577,2666,3190,3484,5.0,5.1,6.1,20.2,1109,1097,1553,1468,1569,1637,5547
92236,9415,42506,2021,2507,2846,3210,4.8,5.9,6.7,22.1,1139,1457,1338,882,1050,1508,4284
92239,16,296,9,5,0,4,3.0,1.7,0.0,5.4,9,0,0,0,5,0,5
92240,10575,40755,2915,2339,3369,3541,7.2,5.7,8.3,25.9,1288,1267,1958,1627,1072,1411,5238
92241,1251,8232,268,528,344,203,3.3,6.4,4.2,15.2,60,215,110,208,313,234,785
92242,176,1230,60,25,76,18,4.9,2.0,6.2,14.3,51,17,54,9,8,22,47
92243,14520,49193,3248,4243,4623,3940,6.6,8.6,9.4,29.5,1790,1701,2563,1458,2542,2060,7061
92249,2269,7910,758,592,512,611,9.6,7.5,6.5,28.7,294,474,328,464,118,184,1031
92250,2161,8033,422,447,952,634,5.3,5.6,11.9,26.9,149,178,563,273,269,389,1083
92251,7975,27050,2198,1800,2505,2461,8.1,6.7,9.3,29.5,1122,778,1378,1076,1022,1127,4071
92252,1384,7911,397,326,347,461,5.0,4.1,4.4,17.5,153,110,118,244,216,229,901
92253,6932,37898,1620,2149,1810,1994,4.3,5.7,4.8,18.3,938,1372,1180,682,777,630,2569
92254,1728,9362,201,571,519,826,2.1,6.1,5.5,18.5,119,159,379,82,412,140,947
92256,633,3387,179,175,224,135,5.3,5.2,6.6,18.7,133,87,106,46,88,118,284
92257,389,1186,159,68,94,77,13.4,5.7,7.9,32.8,51,42,34,108,26,60,228
92258,107,547,15,24,53,29,2.7,4.4,9.7,19.6,0,24,28,15,0,25,55
92259,0,225,0,0,0,0,0.0,0.0,0.0,0.0,0,0,0,0,0,0,0
92260,4186,31039,810,980,1527,1479,2.6,3.2,4.9,13.5,412,418,665,398,562,862,2224
92262,2941,25856,683,915,886,696,2.6,3.5,3.4,11.4,481,555,545,202,360,341,1190
92264,1186,20229,270,271,393,573,1.3,1.3,1.9,5.9,173,175,174,97,96,219,501
92266,0,170,0,0,0,0,0.0,0.0,0.0,0.0,0,0,0,0,0,0,0
92267,0,0,0,0,0,0,,,,,0,0,0,0,0,0,0
92268,0,405,0,0,0,0,0.0,0.0,0.0,0.0,0,0,0,0,0,0,0
92270,1493,17257,303,334,468,525,1.8,1.9,2.7,8.7,105,169,326,198,165,142,646
92273,447,1631,247,100,100,0,15.1,6.1,6.1,27.4,139,50,25,108,50,75,233
92274,3027,15917,760,938,901,756,4.8,5.9,5.7,19.0,352,410,448,408,528,453,1603
92275,363,1406,0,29,146,278,0.0,2.1,10.4,25.8,0,13,114,0,16,32,161
92276,2257,8242,352,776,539,901,4.3,9.4,6.5,27.4,63,434,221,289,342,318,1342
92277,8194,27370,3906,1967,1479,1242,14.3,7.2,5.4,29.9,1975,945,835,1931,1022,644,3848
92278,0,3574,0,0,0,1123,0.0,0.0,0.0,0.0,0,0,0,0,0,0,0
92280,0,0,0,0,0,0,,,,,0,0,0,0,0,0,0
92281,831,2238,275,212,224,302,12.3,9.5,10.0,37.1,130,120,99,145,92,125,393
92282,255,1361,57,80,67,68,4.2,5.9,4.9,18.7,14,65,33,43,15,34,139
92283,662,1967,164,147,253,160,8.3,7.5,12.9,33.7,107,41,146,57,106,107,332
92284,5949,25741,1121,1839,1832,1849,4.4,7.1,7.1,23.1,697,765,1055,424,1074,777,3010
92285,216,2726,48,66,102,278,1.8,2.4,3.7,7.9,0,55,53,48,11,49,108
92301,12849,38565,3163,3382,4137,3511,8.2,8.8,10.7,33.3,1930,1823,1986,1233,1559,2151,6064
92304,0,0,0,0,0,0,,,,,0,0,0,0,0,0,0
92305,202,500,89,69,44,0,17.8,13.8,8.8,40.4,46,38,6,43,31,38,112
92307,10693,40534,2963,3080,2777,2994,7.3,7.6,6.9,26.4,1563,1594,1676,1400,1486,1101,4817
92308,13210,43191,3388,3439,3906,3202,7.8,8.0,9.0,30.6,1574,1535,2147,1814,1904,1759,6525
92309,159,561,63,34,26,73,11.2,6.1,4.6,28.3,7,20,26,56,14,0,82
92310,2671,8967,1094,812,678,526,12.2,9.1,7.6,29.8,610,414,346,484,398,332,1301
92311,10378,34226,2877,2968,2846,2653,8.4,8.7,8.3,30.3,1322,1548,1371,1555,1420,1475,4988
92313,2803,13104,796,783,814,871,6.1,6.0,6.2,21.4,418,462,316,378,321,498,1337
92314,2385,10658,676,642,647,762,6.3,6.0,6.1,22.4,439,305,297,237,337,350,1079
92315,1134,5228,240,349,363,245,4.6,6.7,6.9,21.7,124,239,211,116,110,152,509
92316,7968,30656,1452,2082,2676,2728,4.7,6.8,8.7,26.0,898,1241,1687,554,841,989,3045
92317,46,567,27,19,0,0,4.8,3.4,0.0,8.1,27,9,0,0,10,0,10
92320,2251,10366,540,535,770,632,5.2,5.2,7.4,21.7,349,273,469,191,262,301,960
92321,158,784,34,30,81,13,4.3,3.8,10.3,20.2,9,16,13,25,14,68,107
92322,89,746,29,30,30,0,3.9,4.0,4.0,11.9,29,0,30,0,30,0,30
92324,14007,57593,3321,3747,4146,4842,5.8,6.5,7.2,24.3,1669,1881,2091,1652,1866,2055,7185
92325,1630,8449,499,442,542,329,5.9,5.2,6.4,19.3,159,141,425,340,301,117,831
92327,86,633,0,34,26,26,0.0,5.4,4.1,13.6,0,34,0,0,0,26,26
92328,56,1022,20,9,0,27,2.0,0.9,0.0,5.5,20,9,0,0,0,0,0
92332,21,177,0,10,11,0,0.0,5.6,6.2,11.9,0,0,0,0,10,11,21
92333,34,429,20,0,6,47,4.7,0.0,1.4,7.9,20,0,0,0,0,6,6
92335,27803,96704,6193,7815,9015,8353,6.4,8.1,9.3,28.8,3315,4124,5086,2878,3691,3929,13127
92336,27833,100571,6150,6991,8325,9462,6.1,7.0,8.3,27.7,3404,3451,4158,2746,3540,4167,13447
92337,9497,37292,2213,2645,2744,3139,5.9,7.1,7.4,25.5,1205,1164,1222,1008,1481,1522,4748
92338,0,0,0,0,0,0,,,,,0,0,0,0,0,0,0
92339,313,1064,66,151,44,66,6.2,14.2,4.1,29.4,66,127,27,0,24,17,47
92341,56,331,24,20,0,25,7.3,6.0,0.0,16.9,0,20,0,24,0,0,36
92342,1409,6317,241,607,306,315,3.8,9.6,4.8,22.3,37,337,213,204,270,93,693
92344,5136,20448,722,1454,2127,1561,3.5,7.1,10.4,25.1,438,745,1314,284,709,813,2227
92345,25665,87476,6395,6957,7828,6743,7.3,8.0,8.9,29.3,3476,3584,3963,2919,3373,3865,12748
92346,15638,60025,4481,4019,4371,4705,7.5,6.7,7.3,26.1,2326,2176,2581,2155,1843,1790,7233
92347,105,601,0,0,105,0,0.0,0.0,17.5,17.5,0,0,82,0,0,23,23
92350,0,468,0,0,0,79,0.0,0.0,0.0,0.0,0,0,0,0,0,0,0
92352,1220,6147,192,403,377,415,3.1,6.6,6.1,19.8,14,264,261,178,139,116,526
92354,4349,23054,978,1143,1366,1297,4.2,5.0,5.9,18.9,534,497,631,444,646,735,2306
92356,1719,7048,509,479,456,447,7.2,6.8,6.5,24.4,195,340,215,314,139,241,794
92358,49,762,7,0,35,65,0.9,0.0,4.6,6.4,0,0,35,7,0,0,7
92359,2414,9758,625,949,489,488,6.4,9.7,5.0,24.7,429,530,241,196,419,248,997
92363,1127,5447,215,292,393,341,3.9,5.4,7.2,20.7,122,115,171,93,177,222,583
92364,0,12,0,0,0,0,0.0,0.0,0.0,0.0,0,0,0,0,0,0,0
92365,469,2393,164,76,82,251,6.9,3.2,3.4,19.6,72,50,75,92,26,7,162
92368,276,1018,58,70,103,72,5.7,6.9,10.1,27.1,33,30,48,25,40,55,156
92369,34,3999,34,0,0,0,0.9,0.0,0.0,0.9,34,0,0,0,0,0,0
92371,6472,21265,1759,2251,1266,1802,8.3,10.6,6.0,30.4,825,942,583,934,1309,683,3542
92372,1378,5208,527,366,400,93,10.1,7.0,7.7,26.5,315,94,213,212,272,187,756
92373,7473,33946,1860,2355,2078,1745,5.5,6.9,6.1,22.0,1018,1225,893,842,1130,1185,3740
92374,10488,44976,2969,2764,3055,3730,6.6,6.1,6.8,23.3,1484,1608,1537,1485,1156,1518,4848
92376,23625,85727,5353,6423,7520,7563,6.2,7.5,8.8,27.6,2406,3201,3977,2947,3222,3543,11829
92377,5336,20935,1232,1645,1234,1654,5.9,7.9,5.9,25.5,719,865,563,513,780,671,2666
92378,110,437,0,42,45,48,0.0,9.6,10.3,25.2,0,28,17,0,14,28,65
92382,1277,4884,461,335,268,273,9.4,6.9,5.5,26.1,192,191,141,269,144,127,611
92384,0,23,0,0,0,0,0.0,0.0,0.0,0.0,0,0,0,0,0,0,0
92385,0,167,0,0,0,0,0.0,0.0,0.0,0.0,0,0,0,0,0,0,0
92386,426,2064,322,34,44,26,15.6,1.6,2.1,20.6,71,17,21,251,17,23,317
92389,0,187,0,0,0,0,0.0,0.0,0.0,0.0,0,0,0,0,0,0,0
92391,411,2177,104,184,108,32,4.8,8.5,5.0,18.9,90,81,28,14,103,80,197
92392,18638,61859,4524,5111,5880,4979,7.3,8.3,9.5,30.1,2151,2777,2930,2373,2334,2950,9303
92394,11843,39939,3402,2862,3920,3233,8.5,7.2,9.8,29.7,1885,1520,1904,1517,1342,2016,5689
92395,14226,48479,2834,3972,5331,3434,5.8,8.2,11.0,29.3,1392,1936,2928,1442,2036,2403,6739
92397,908,5059,285,240,359,47,5.6,4.7,7.1,17.9,191,96,237,94,144,122,384
92398,166,1394,21,45,69,31,1.5,3.2,4.9,11.9,21,10,44,0,35,25,60
92399,13997,55236,3773,4020,3778,3809,6.8,7.3,6.8,25.3,1807,1498,1883,1966,2522,1895,7389
92401,546,2060,114,200,173,116,5.5,9.7,8.4,26.5,71,104,81,43,96,92,275
92404,18370,64090,4950,4469,5491,5377,7.7,7.0,8.6,28.7,2267,2491,2847,2683,1978,2644,8728
92405,10154,31550,2371,3083,3318,2133,7.5,9.8,10.5,32.2,1242,1386,1912,1129,1697,1406,4877
92407,18872,67207,5303,5147,5111,5397,7.9,7.7,7.6,28.1,2362,2662,2371,2941,2485,2740,9904
92408,3016,12478,830,928,735,837,6.7,7.4,5.9,24.2,385,521,330,445,407,405,1553
92410,14139,48398,2957,4211,4682,3926,6.1,8.7,9.7,29.2,1750,1876,2498,1207,2335,2184,6834
92411,8019,26915,1686,2263,2395,2997,6.3,8.4,8.9,29.8,755,1317,1146,931,946,1249,4026
92415,0,0,0,0,0,0,,,,,0,0,0,0,0,0,0
92501,5060,22136,1046,1375,1776,1635,4.7,6.2,8.0,22.9,478,803,1145,568,572,631,2164
92503,23332,88617,5201,6080,8148,6605,5.9,6.9,9.2,26.3,2869,2797,3981,2332,3283,4167,11648
92504,12640,57636,3472,2638,4114,4901,6.0,4.6,7.1,21.9,2000,1427,2222,1472,1211,1892,5646
92505,13037,52696,2969,3609,3924,4204,5.6,6.8,7.4,24.7,1372,2099,1758,1597,1510,2166,6650
92506,10843,44344,2642,3330,2967,2751,6.0,7.5,6.7,24.5,1367,2079,1696,1275,1251,1271,4853
92507,11579,60949,3409,2938,3016,8459,5.6,4.8,4.9,19.0,1848,1475,1688,1561,1463,1328,5238
92508,9544,36500,2135,2618,3132,2660,5.8,7.2,8.6,26.1,937,1232,1492,1198,1386,1640,5028
92509,21134,80325,5195,5084,6670,6923,6.5,6.3,8.3,26.3,2919,2470,2881,2276,2614,3789,10463
92518,314,1132,36,59,206,31,3.2,5.2,18.2,27.7,18,41,127,18,18,79,128
92521,0,0,0,0,0,0,,,,,0,0,0,0,0,0,0
92530,16215,58249,4341,4635,4276,4916,7.5,8.0,7.3,27.8,1956,2239,2130,2385,2396,2146,8493
92532,7837,27454,2373,2149,2028,1678,8.6,7.8,7.4,28.5,1522,1254,1323,851,895,705,2792
92536,439,2569,78,204,105,52,3.0,7.9,4.1,17.1,0,110,0,78,94,105,287
92539,790,3760,274,341,164,59,7.3,9.1,4.4,21.0,101,279,47,173,62,117,352
92543,9627,38403,2278,2533,2887,2851,5.9,6.6,7.5,25.1,908,1431,1636,1370,1102,1251,4601
92544,13920,51567,3438,3857,3879,3915,6.7,7.5,7.5,27.0,1694,1831,1961,1744,2026,1918,7076
92545,10196,45219,2713,3468,2455,2516,6.0,7.7,5.4,22.5,1491,1694,1291,1222,1774,1164,4865
92548,1968,7110,288,727,686,513,4.1,10.2,9.6,27.7,139,345,316,149,382,370,989
92549,506,3535,103,176,66,299,2.9,5.0,1.9,14.3,75,14,66,28,162,0,208
92551,9692,36326,2373,3140,2846,2948,6.5,8.6,7.8,26.7,1155,1767,1539,1218,1373,1307,4495
92553,21327,73945,4802,5549,7034,6457,6.5,7.5,9.5,28.8,2536,2686,3086,2266,2863,3948,11091
92555,11273,44923,2617,2981,3609,3185,5.8,6.6,8.0,25.1,1492,1583,1713,1125,1398,1896,5528
92557,14335,54936,3775,3956,4439,3496,6.9,7.2,8.1,26.1,1954,2124,2094,1821,1832,2345,7197
92561,245,1622,156,0,63,35,9.6,0.0,3.9,15.1,78,0,44,78,0,19,118
92562,17231,64155,4493,4647,4916,5079,7.0,7.2,7.7,26.9,2271,2339,3105,2222,2308,1811,8299
92563,21431,78139,4779,6440,5809,7033,6.1,8.2,7.4,27.4,2369,2724,3189,2410,3716,2620,11100
92567,3290,10721,613,614,1406,1027,5.7,5.7,13.1,30.7,327,374,542,286,240,864,1820
92570,16063,58275,3764,4281,4832,5056,6.5,7.3,8.3,27.6,1806,1945,2547,1958,2336,2285,8080
92571,18283,59896,4638,5246,5459,4996,7.7,8.8,9.1,30.5,2018,2786,2729,2620,2460,2730,9361
92582,7192,21961,1616,1288,2554,2231,7.4,5.9,11.6,32.7,1156,764,978,460,524,1576,3316
92583,9066,33781,2502,2153,2773,2880,7.4,6.4,8.2,26.8,1053,1232,1228,1449,921,1545,4587
92584,15518,54663,3923,4690,4589,3228,7.2,8.6,8.4,28.4,1942,2199,2241,1981,2491,2348,8070
92585,7705,27083,1405,2255,2265,2495,5.2,8.3,8.4,28.4,602,1239,1473,803,1016,792,3268
92586,2809,20152,791,704,959,533,3.9,3.5,4.8,13.9,588,293,552,203,411,407,1244
92587,5139,18926,1507,1605,1252,1000,8.0,8.5,6.6,27.2,1072,780,631,435,825,621,2229
92590,1108,5212,349,225,385,327,6.7,4.3,7.4,21.3,129,140,234,220,85,151,535
92591,10048,41047,2221,3262,2989,2453,5.4,7.9,7.3,24.5,896,1965,1697,1325,1297,1292,4742
92592,23491,81636,5209,6530,7230,6367,6.4,8.0,8.9,28.8,2493,3476,3508,2716,3054,3722,11834
92595,8130,34698,2282,2145,2209,2532,6.6,6.2,6.4,23.4,1365,1002,1222,917,1143,987,3778
92596,11615,35726,3005,3129,3626,2590,8.4,8.8,10.1,32.5,1643,1617,1728,1362,1512,1898,5651
92602,7086,26663,1564,1872,2184,2016,5.9,7.0,8.2,26.6,1059,812,690,505,1060,1494,3867
92603,3706,19329,1136,901,1101,797,5.9,4.7,5.7,19.2,526,376,696,610,525,405,1860
92604,5971,29080,1408,1615,1763,1942,4.8,5.6,6.1,20.5,736,945,708,672,670,1055,2998
92606,5293,24431,1613,1555,1489,1496,6.6,6.4,6.1,21.7,840,809,534,773,746,955,2784
92610,2609,13107,654,741,735,756,5.0,5.7,5.6,19.9,287,436,343,367,305,392,1316
92612,4112,34868,1780,570,1061,2933,5.1,1.6,3.0,11.8,616,275,717,1164,295,344,2167
92614,6884,29544,2453,1675,1718,1872,8.3,5.7,5.8,23.3,1566,1006,771,887,669,947,3055
92617,2194,20432,806,625,451,5733,3.9,3.1,2.2,10.7,535,240,240,271,385,211,1141
92618,14473,59386,5351,3943,3007,3326,9.0,6.6,5.1,24.4,3292,2278,1527,2059,1665,1480,6225
92620,16595,61110,4207,4262,5170,4001,6.9,7.0,8.5,27.2,2214,2253,2609,1993,2009,2561,7989
92624,1254,6881,310,287,419,288,4.5,4.2,6.1,18.2,185,60,67,125,227,352,813
92625,2250,12546,434,446,816,664,3.5,3.6,6.5,17.9,184,139,360,250,307,456,1231
92626,8713,50198,2540,2148,2667,2434,5.1,4.3,5.3,17.4,1257,1005,1286,1283,1143,1381,4446
92627,12731,62181,3407,3175,3845,4287,5.5,5.1,6.2,20.5,1714,1847,1751,1693,1328,2094,6388
92629,4644,26144,1196,691,1707,1717,4.6,2.6,6.5,17.8,780,565,789,416,126,918,1838
92630,13406,66240,4350,3740,2966,3622,6.6,5.6,4.5,20.2,2389,2051,1596,1961,1689,1370,6149
92637,51,17452,0,35,16,0,0.0,0.2,0.1,0.3,0,35,0,0,0,16,16
92646,10328,56033,2112,3089,2841,3516,3.8,5.5,5.1,18.4,880,1570,1711,1232,1519,1130,4883
92647,11319,60114,3343,2609,3429,3447,5.6,4.3,5.7,18.8,1948,1197,1712,1395,1412,1717,5619
92648,8099,45667,2220,2080,2117,2454,4.9,4.6,4.6,17.7,1278,1047,1203,942,1033,914,3729
92649,5519,35206,1599,1219,1714,1764,4.5,3.5,4.9,15.7,885,627,1032,714,592,682,2488
92651,3658,23981,569,854,1352,1382,2.4,3.6,5.6,15.3,348,517,607,221,337,745,1785
92653,5766,29923,1111,1846,1850,1664,3.7,6.2,6.2,19.3,470,1081,1012,641,765,838,2712
92655,1718,8040,318,494,569,480,4.0,6.1,7.1,21.4,246,274,251,72,220,318,775
92656,12893,53143,3586,3333,3922,3420,6.7,6.3,7.4,24.3,1713,1527,1880,1873,1806,2042,6648
92657,2182,9169,429,390,935,533,4.7,4.3,10.2,23.8,307,142,465,122,248,470,1101
92660,7149,35926,1635,2088,2123,1822,4.6,5.8,5.9,19.9,876,1102,865,759,986,1258,3457
92661,351,3300,24,137,76,137,0.7,4.2,2.3,10.6,24,126,23,0,11,53,105
92662,184,2346,20,12,27,170,0.9,0.5,1.2,7.8,4,12,27,16,0,0,77
92663,2181,21886,583,485,880,410,2.7,2.2,4.0,10.0,273,225,598,310,260,282,881
92672,6889,38020,1706,1615,2237,2322,4.5,4.2,5.9,18.1,906,638,1240,800,977,997,3414
92673,8487,30633,1894,1877,3009,2462,6.2,6.1,9.8,27.7,967,959,1892,927,918,1117,3496
92675,8112,35099,1671,2342,2232,2385,4.8,6.7,6.4,23.1,789,977,1115,882,1365,1117,4358
92676,461,1952,117,110,90,163,6.0,5.6,4.6,23.6,31,38,37,86,72,53,287
92677,10919,64259,2345,2890,3627,3566,3.6,4.5,5.6,17.0,1128,1587,1910,1217,1303,1717,5032
92678,95,630,46,0,22,37,7.3,0.0,3.5,15.1,29,0,5,17,0,17,45
92679,6635,30971,1341,1578,2208,2324,4.3,5.1,7.1,21.4,683,758,1102,658,820,1106,3462
92683,19219,90630,4818,4563,6254,5996,5.3,5.0,6.9,21.2,2250,1885,3028,2568,2678,3226,10180
92688,10750,44444,2746,2829,3022,3480,6.2,6.4,6.8,24.2,1259,1635,1550,1487,1194,1472,5185
92691,9773,48073,2886,2404,2628,2629,6.0,5.0,5.5,20.3,1252,1182,1460,1634,1222,1168,4827
92692,8830,45977,2293,2424,2755,2464,5.0,5.3,6.0,19.2,1187,1278,1234,1106,1146,1521,4451
92694,11862,35074,3285,3592,3245,2702,9.4,10.2,9.3,33.8,1545,1723,1804,1740,1869,1441,5920
92697,0,0,0,0,0,0,,,,,0,0,0,0,0,0,0
92701,13624,49462,2677,4096,4452,4122,5.4,8.3,9.0,27.5,1441,2314,2588,1236,1782,1864,5922
92703,14234,61593,3510,3948,3798,5471,5.7,6.4,6.2,23.1,1917,2213,2145,1593,1735,1653,6541
92704,18619,80767,4785,4401,5599,6327,5.9,5.4,6.9,23.1,2397,2135,2745,2388,2266,2854,9443
92705,11274,46854,2701,3308,3131,3484,5.8,7.1,6.7,24.1,1235,1928,1404,1466,1380,1727,5607
92706,8416,36548,2369,2029,2394,2852,6.5,5.6,6.6,23.0,1255,1129,1256,1114,900,1138,3938
92707,13834,59712,3529,3395,4822,4515,5.9,5.7,8.1,23.2,1585,1883,2424,1944,1512,2398,7074
92708,10939,56754,2324,2691,3517,3732,4.1,4.7,6.2,19.3,1401,1573,1822,923,1118,1695,5080
92780,13422,54945,3572,3503,4198,3499,6.5,6.4,7.6,24.4,2170,1537,2266,1402,1966,1932,6114
92782,6769,29838,1924,1678,2175,2090,6.4,5.6,7.3,22.7,1146,759,1537,778,919,638,2827
92801,14850,64022,4120,4004,4354,4636,6.4,6.3,6.8,23.2,2313,2007,2276,1807,1997,2078,7115
92802,11510,44316,2583,3472,3276,3265,5.8,7.8,7.4,26.0,1681,1704,1575,902,1768,1701,5202
92804,18664,84700,4707,5039,5370,6007,5.6,5.9,6.3,22.0,2388,2504,2421,2319,2535,2949,9704
92805,17636,73310,4291,4466,5457,5975,5.9,6.1,7.4,24.1,1719,2399,2339,2572,2067,3118,9469
92806,9431,40945,3204,2449,2346,2344,7.8,6.0,5.7,23.0,1480,1462,1302,1724,987,1044,4435
92807,7287,36117,1735,1867,2236,2216,4.8,5.2,6.2,20.2,966,911,1255,769,956,981,3522
92808,4320,21080,1271,983,1215,1236,6.0,4.7,5.8,20.5,749,508,714,522,475,501,2012
92821,9078,41604,2028,2371,2906,2899,4.9,5.7,7.0,21.8,1182,1143,1460,846,1228,1446,4742
92823,1352,5495,392,433,233,390,7.1,7.9,4.2,24.6,128,140,157,264,293,76,765
92831,6638,36470,1757,1537,1964,2884,4.8,4.2,5.4,18.2,943,943,1286,814,594,678,2766
92832,6686,26040,1839,1664,2078,1606,7.1,6.4,8.0,25.7,762,674,1209,1077,990,869,3617
92833,12433,52799,3298,3213,4328,3261,6.2,6.1,8.2,23.5,1586,1817,2276,1712,1396,2052,6047
92835,6079,26687,1815,1366,2163,1020,6.8,5.1,8.1,22.8,652,393,1030,1163,973,1133,3657
92840,11540,53826,2606,2995,3482,4159,4.8,5.6,6.5,21.4,1165,1459,1916,1441,1536,1566,5798
92841,7301,34188,1748,1904,2168,2489,5.1,5.6,6.3,21.4,804,1087,1163,944,817,1005,3588
92843,10572,47549,2697,2653,3050,3746,5.7,5.6,6.4,22.2,1307,1293,1519,1390,1360,1531,5220
92844,4169,22622,990,971,1311,1472,4.4,4.3,5.8,18.4,431,590,582,559,381,729,2139
92845,3086,15530,855,847,917,801,5.5,5.5,5.9,19.9,511,425,631,344,422,286,1271
92860,4588,25367,1070,1199,1649,1131,4.2,4.7,6.5,18.1,625,629,863,445,570,786,2104
92861,1228,5814,201,373,418,305,3.5,6.4,7.2,21.1,65,158,260,136,215,158,565
92865,4619,21140,1231,1498,1252,987,5.8,7.1,5.9,21.8,744,867,571,487,631,681,2047
92866,2649,14873,814,544,747,908,5.5,3.7,5.0,17.8,442,273,484,372,271,263,1088
92867,9521,44216,2533,2466,2720,4151,5.7,5.6,6.2,21.5,1328,1303,1339,1205,1163,1381,4431
92868,5040,27280,1256,1510,1265,1588,4.6,5.5,4.6,18.5,435,790,673,821,720,592,2582
92869,7669,36429,2010,2241,2064,2098,5.5,6.2,5.7,21.1,787,1268,1059,1223,973,1005,3742
92870,12575,53150,2868,3494,3701,3677,5.4,6.6,7.0,23.7,1483,1483,1811,1385,2011,1890,6223
92879,11673,49111,2798,3047,3759,3283,5.7,6.2,7.7,23.8,1423,1810,1922,1375,1237,1837,5485
92880,21465,74645,5990,5485,6566,5907,8.0,7.3,8.8,28.8,3273,2603,3621,2717,2882,2945,10307
92881,7429,31401,1454,1910,2463,2828,4.6,6.1,7.8,23.7,846,975,1512,608,935,951,3154
92882,17363,69472,4145,4460,5583,4968,6.0,6.4,8.0,25.0,1926,2355,2770,2219,2105,2813,8744
92883,9341,37211,2394,2198,3123,2852,6.4,5.9,8.4,25.1,1190,1097,1456,1204,1101,1667,4990
92886,12023,50437,2487,3833,3524,3219,4.9,7.6,7.0,23.8,1152,2061,1803,1335,1772,1721,5902
92887,4042,20353,1145,1185,1076,1193,5.6,5.8,5.3,19.9,700,686,442,445,499,634,1935
93001,6034,31751,1614,1487,1885,1612,5.1,4.7,5.9,19.0,632,746,902,982,741,983,3376
93003,11314,53283,2530,3238,3010,3751,4.7,6.1,5.6,21.2,1257,1866,1352,1273,1372,1658,5667
93004,6234,31151,1601,2001,1385,2148,5.1,6.4,4.4,20.0,810,1133,706,791,868,679,2915
93010,10258,47656,3245,2779,2430,3194,6.8,5.8,5.1,21.5,1806,1438,1384,1439,1341,1046,4577
93012,6459,36145,1693,1429,2013,2757,4.7,4.0,5.6,17.9,1000,706,1103,693,723,910,3069
93013,3228,16459,941,811,1210,612,5.7,4.9,7.4,19.6,519,378,657,422,433,553,1552
93015,4682,18716,704,1358,1831,1561,3.8,7.3,9.8,25.0,313,711,687,391,647,1144,2611
93021,8813,37980,2164,2562,2361,2488,5.7,6.7,6.2,23.2,1136,1064,1153,1028,1498,1208,4495
93022,1271,6422,426,298,373,291,6.6,4.6,5.8,19.8,216,91,215,210,207,158,646
93023,3297,21279,807,849,998,1107,3.8,4.0,4.7,15.5,444,414,683,363,435,315,1535
93030,14918,58511,3833,4506,4070,4502,6.6,7.7,7.0,25.5,1843,2522,2438,1990,1984,1632,7027
93033,24204,82517,5963,6918,7114,6916,7.2,8.4,8.6,29.3,2606,3420,3699,3357,3498,3415,12216
93035,5264,26286,1036,1193,2016,1803,3.9,4.5,7.7,20.0,528,470,1171,508,723,845,2612
93036,11750,46959,2392,3391,4058,2935,5.1,7.2,8.6,25.0,1276,1681,2012,1116,1710,2046,5837
93040,484,1838,251,97,87,100,13.7,5.3,4.7,26.3,113,30,55,138,67,32,286
93041,5704,23108,1756,1634,1746,1038,7.6,7.1,7.6,24.7,741,879,895,1015,755,851,2934
93042,0,107,0,0,0,25,0.0,0.0,0.0,0.0,0,0,0,0,0,0,0
93043,0,722,0,0,0,82,0.0,0.0,0.0,0.0,0,0,0,0,0,0,0
93060,9194,34337,2331,2364,2798,2757,6.8,6.9,8.1,26.8,1216,1059,1280,1115,1305,1518,4777
93063,10848,57075,2581,2859,3562,2870,4.5,5.0,6.2,19.0,1662,1520,1333,919,1339,2229,5430
93064,0,0,0,0,0,0,,,,,0,0,0,0,0,0,0
93065,15311,72086,3128,3768,5033,5136,4.3,5.2,7.0,21.2,1804,1850,2490,1324,1918,2543,7439
93066,436,2805,84,64,182,193,3.0,2.3,6.5,15.5,41,27,67,43,37,115,202
93067,235,999,114,31,30,119,11.4,3.1,3.0,23.5,41,0,30,73,31,0,104
93101,5547,29870,1745,1501,1357,1755,5.8,5.0,4.5,18.6,1058,853,735,687,648,622,2392
93103,3447,19653,1107,829,1100,661,5.6,4.2,5.6,17.5,515,407,449,592,422,651,1861
93105,4268,26482,1220,1149,994,1483,4.6,4.3,3.8,16.1,765,688,595,455,461,399,1770
93106,88,5369,0,0,0,2529,0.0,0.0,0.0,1.6,0,0,0,0,0,0,45
93108,1473,11209,399,406,411,901,3.6,3.6,3.7,13.1,221,171,148,178,235,263,800
93109,1542,11626,314,273,469,1402,2.7,2.3,4.0,13.3,130,133,216,184,140,253,830
93110,2899,16403,710,778,916,781,4.3,4.7,5.6,17.7,329,513,456,381,265,460,1282
93111,3802,18165,723,1284,1342,827,4.0,7.1,7.4,20.9,249,479,828,474,805,514,1989
93117,7380,53345,1891,1747,2156,8464,3.5,3.3,4.0,13.8,984,912,1382,907,835,774,3454
93201,478,1209,205,155,93,52,17.0,12.8,7.7,39.5,72,36,49,133,119,44,306
93202,1489,4308,354,466,534,410,8.2,10.8,12.4,34.6,238,234,376,116,232,158,614
93203,7485,20781,2002,2035,2279,2063,9.6,9.8,11.0,36.0,1009,964,1123,993,1071,1156,3718
93204,3781,13423,990,915,1369,931,7.4,6.8,10.2,28.2,470,382,705,520,533,664,1947
93205,535,2320,122,46,258,109,5.3,2.0,11.1,23.1,0,46,215,122,0,43,165
93206,616,1709,109,184,191,185,6.4,10.8,11.2,36.0,85,89,69,24,95,122,306
93207,52,232,9,6,30,19,3.9,2.6,12.9,22.4,9,6,16,0,0,14,21
93208,0,127,0,0,0,0,0.0,0.0,0.0,0.0,0,0,0,0,0,0,0
93210,4596,18937,905,1228,1402,1541,4.8,6.5,7.4,24.3,471,546,615,434,682,787,2517
93212,5026,23391,1286,1337,1583,1245,5.5,5.7,6.8,21.5,535,754,616,751,583,967,2686
93215,13257,53334,3066,3403,3816,4775,5.7,6.4,7.2,24.9,1497,2121,2278,1569,1282,1538,5511
93218,309,796,148,59,55,68,18.6,7.4,6.9,38.8,37,44,18,111,15,37,186
93219,3093,9871,707,748,999,1370,7.2,7.6,10.1,31.3,312,352,549,395,396,450,1542
93220,0,0,0,0,0,0,,,,,0,0,0,0,0,0,0
93221,3982,14423,755,1146,1514,904,5.2,7.9,10.5,27.6,358,535,748,397,611,766,1990
93222,296,2036,30,51,116,123,1.5,2.5,5.7,14.5,30,34,70,0,17,46,63
93223,2994,10424,540,843,1010,1085,5.2,8.1,9.7,28.7,322,441,310,218,402,700,1533
93224,152,501,24,39,56,52,4.8,7.8,11.2,30.3,21,17,15,3,22,41,85
93225,839,5018,184,84,415,298,3.7,1.7,8.3,16.7,126,21,254,58,63,161,357
93226,0,55,0,0,0,0,0.0,0.0,0.0,0.0,0,0,0,0,0,0,0
93227,44,227,0,0,44,0,0.0,0.0,19.4,19.4,0,0,44,0,0,0,0
93230,19377,68572,4767,4827,6551,4903,7.0,7.0,9.6,28.3,2313,2287,3500,2454,2540,3051,9622
93234,2275,6571,552,559,770,491,8.4,8.5,11.7,34.6,214,274,403,338,285,367,1249
93235,1346,4360,255,472,537,499,5.8,10.8,12.3,30.9,143,169,319,112,303,218,633
93237,2,98,0,0,0,2,0.0,0.0,0.0,2.0,0,0,0,0,0,0,1
93238,220,866,81,8,130,1,9.4,0.9,15.0,25.4,81,0,62,0,8,68,76
93239,331,1404,95,19,130,87,6.8,1.4,9.3,23.6,54,0,17,41,19,113,173
93240,1385,5470,308,123,807,196,5.6,2.2,14.8,25.3,123,37,504,185,86,303,596
93241,5384,15978,1376,1675,1608,1412,8.6,10.5,10.1,33.7,782,830,795,594,845,813,2560
93242,858,2683,231,192,170,321,8.6,7.2,6.3,32.0,94,109,64,137,83,106,382
93243,126,977,54,56,16,34,5.5,5.7,1.6,12.9,0,56,14,54,0,2,56
93244,16,121,0,14,2,1,0.0,11.6,1.7,13.2,0,8,2,0,6,0,6
93245,10168,37439,3374,2490,2692,2652,9.0,6.7,7.2,27.2,1770,1488,1288,1604,1002,1404,4811
93246,0,1129,0,0,0,214,0.0,0.0,0.0,0.0,0,0,0,0,0,0,0
93247,5518,17827,1100,1657,1718,1524,6.2,9.3,9.6,31.0,576,941,1053,524,716,665,2619
93249,749,1996,153,204,249,229,7.7,10.2,12.5,37.5,97,89,150,56,115,99,327
93250,5203,15126,1112,1432,1786,1587,7.4,9.5,11.8,34.4,659,635,896,453,797,890,2594
93251,80,293,16,35,20,27,5.5,11.9,6.8,27.3,14,18,11,2,17,9,37
93252,424,1680,83,151,129,100,4.9,9.0,7.7,25.2,38,61,41,45,90,88,242
93254,192,869,85,50,53,40,9.8,5.8,6.1,22.1,28,14,17,57,36,36,133
93255,0,872,0,0,0,0,0.0,0.0,0.0,0.0,0,0,0,0,0,0,0
93256,1776,5575,334,570,429,685,6.0,10.2,7.7,31.9,243,252,213,91,318,216,766
93257,23865,79217,5410,5763,8171,6820,6.8,7.3,10.3,30.1,3105,2912,4245,2305,2851,3926,11417
93258,206,1086,35,71,80,60,3.2,6.5,7.4,19.0,0,36,37,35,35,43,113
93260,40,178,12,11,6,27,6.7,6.2,3.4,22.5,5,6,6,7,5,0,12
93261,591,1889,86,194,222,159,4.6,10.3,11.8,31.3,65,114,58,21,80,164,324
93262,0,18,0,0,0,0,0.0,0.0,0.0,0.0,0,0,0,0,0,0,0
93263,7631,22952,1620,2080,2458,2360,7.1,9.1,10.7,33.2,839,914,1204,781,1166,1254,4137
93265,622,3194,145,237,154,157,4.5,7.4,4.8,19.5,63,92,122,82,145,32,309
93266,549,1720,207,157,133,145,12.0,9.1,7.7,31.9,154,65,47,53,92,86,231
93267,1953,5811,354,620,366,669,6.1,10.7,6.3,33.6,157,511,213,197,109,153,726
93268,4672,17124,1273,1595,1214,1233,7.4,9.3,7.1,27.3,664,628,586,609,967,628,2463
93270,1629,5711,327,474,525,510,5.7,8.3,9.2,28.5,149,317,269,178,157,256,791
93271,402,2398,21,92,214,75,0.9,3.8,8.9,16.8,0,78,80,21,14,134,169
93272,1646,4548,313,469,530,535,6.9,10.3,11.7,36.2,148,209,258,165,260,272,767
93274,26090,78831,6718,7467,7486,6648,8.5,9.5,9.5,33.1,2855,3789,4170,3863,3678,3316,13084
93276,41,150,7,12,16,10,4.7,8.0,10.7,27.3,6,12,12,1,0,4,11
93277,14121,54127,4103,3761,3714,4037,7.6,6.9,6.9,26.1,2387,2152,1655,1716,1609,2059,6499
93280,7357,27356,1964,2468,2101,1250,7.2,9.0,7.7,26.9,801,1184,1174,1163,1284,927,3729
93283,367,2416,84,90,147,65,3.5,3.7,6.1,15.2,84,25,147,0,65,0,86
93285,173,2465,16,17,85,55,0.6,0.7,3.4,7.0,0,9,51,16,8,34,113
93286,3467,10418,1042,908,716,1191,10.0,8.7,6.9,33.3,308,493,363,734,415,353,1972
93287,21,119,15,0,2,4,12.6,0.0,1.7,17.6,15,0,0,0,0,2,6
93291,17992,61439,4561,5341,5498,4529,7.4,8.7,8.9,29.3,2211,2563,2240,2350,2778,3258,9682
93292,12912,44759,3825,3791,3416,2836,8.5,8.5,7.6,28.8,2028,1996,1544,1797,1795,1872,6182
93301,4356,13672,1087,1364,1428,815,8.0,10.0,10.4,31.9,659,648,546,428,716,882,2364
93304,14897,50158,4016,4531,3808,3863,8.0,9.0,7.6,29.7,1765,2444,1969,2251,2087,1839,7567
93305,12173,36783,3134,3586,3850,2544,8.5,9.7,10.5,33.1,1398,2101,1778,1736,1485,2072,5931
93306,22383,74769,5005,6662,6889,6029,6.7,8.9,9.2,29.9,2369,3677,3827,2636,2985,3062,10637
93307,30300,89651,7752,7487,9616,9065,8.6,8.4,10.7,33.8,4228,3459,5137,3524,4028,4479,14736
93308,13525,55150,3569,3650,4274,3572,6.5,6.6,7.7,24.5,1696,1366,2182,1873,2284,2092,7263
93309,16431,62828,4874,4295,4760,3638,7.8,6.8,7.6,26.2,2312,2261,2380,2562,2034,2380,8220
93311,14884,50535,3462,4070,4558,4018,6.9,8.1,9.0,29.5,2315,1935,2330,1147,2135,2228,6871
93312,18330,59616,4819,4334,5992,4866,8.1,7.3,10.1,30.7,2251,2294,3224,2568,2040,2768,8842
93313,18267,59924,5017,4799,4600,5771,8.4,8.0,7.7,30.5,3126,2925,2229,1891,1874,2371,7996
93314,8928,34156,2338,2396,2578,2596,6.8,7.0,7.5,26.1,1368,853,1099,970,1543,1479,4808
93401,4312,28773,1158,1232,1223,1722,4.0,4.3,4.3,15.0,768,594,594,390,638,629,1967
93402,2773,15572,883,746,687,703,5.7,4.8,4.4,17.8,343,471,297,540,275,390,1502
93405,1729,24991,423,518,459,2617,1.7,2.1,1.8,6.9,185,276,192,238,242,267,892
93407,0,309,0,0,0,272,0.0,0.0,0.0,0.0,0,0,0,0,0,0,0
93408,1,11,0,0,0,3,0.0,0.0,0.0,9.1,0,0,0,0,0,0,1
93409,0,2591,0,0,0,0,0.0,0.0,0.0,0.0,0,0,0,0,0,0,0
93410,96,6523,0,0,0,5246,0.0,0.0,0.0,1.5,0,0,0,0,0,0,36
93420,6840,32126,1805,1783,2135,2047,5.6,5.6,6.6,21.3,710,648,920,1095,1135,1215,3970
93422,6647,33781,1799,1889,1742,1922,5.3,5.6,5.2,19.7,952,784,1006,847,1105,736,3212
93424,64,1174,0,64,0,0,0.0,5.5,0.0,5.5,0,33,0,0,31,0,31
93426,261,1566,105,80,29,142,6.7,5.1,1.9,16.7,56,40,12,49,40,17,132
93427,1275,5980,454,250,352,315,7.6,4.2,5.9,21.3,128,169,116,326,81,236,747
93428,828,6056,217,191,278,298,3.6,3.2,4.6,13.7,124,103,152,93,88,126,401
93429,0,64,0,0,0,0,0.0,0.0,0.0,0.0,0,0,0,0,0,0,0
93430,224,2941,33,31,152,91,1.1,1.1,5.2,7.6,23,17,152,10,14,0,32
93432,364,1434,129,0,44,191,9.0,0.0,3.1,25.4,83,0,7,46,0,37,199
93433,2744,12755,714,882,756,442,5.6,6.9,5.9,21.5,302,604,455,412,278,301,1219
93434,2929,8272,849,755,842,581,10.3,9.1,10.2,35.4,437,337,357,412,418,485,1637
93436,13957,55591,3379,4009,4750,3130,6.1,7.2,8.5,25.1,1556,2376,2273,1823,1633,2477,7040
93437,1061,3681,349,382,283,196,9.5,10.4,7.7,28.8,151,169,113,198,213,170,596
93440,90,846,24,48,0,19,2.8,5.7,0.0,10.6,0,0,0,24,48,0,90
93441,147,1085,9,35,61,72,0.8,3.2,5.6,13.5,9,9,40,0,26,21,51
93442,1420,11399,341,377,325,865,3.0,3.3,2.9,12.5,111,178,127,230,199,198,732
93444,4623,22079,982,983,1649,1455,4.4,4.5,7.5,20.9,496,511,1032,486,472,617,2073
93445,1504,6912,464,342,403,342,6.7,4.9,5.8,21.8,219,211,252,245,131,151,619
93446,9962,45720,2586,2618,3234,2606,5.7,5.7,7.1,21.8,1319,1330,1736,1267,1288,1498,4870
93449,952,8050,251,117,341,316,3.1,1.5,4.2,11.8,170,73,238,81,44,103,415
93450,269,830,113,40,77,63,13.6,4.8,9.3,32.4,40,3,47,73,37,30,162
93451,1086,4751,136,400,423,252,2.9,8.4,8.9,22.9,113,283,220,23,117,203,370
93452,89,307,52,37,0,0,16.9,12.1,0.0,29.0,28,37,0,24,0,0,24
93453,175,2096,76,48,26,25,3.6,2.3,1.2,8.3,20,27,13,56,21,13,102
93454,12092,41110,3117,3507,3085,3808,7.6,8.5,7.5,29.4,1905,1883,1441,1212,1624,1644,5421
93455,10383,44186,2624,2500,2890,3769,5.9,5.7,6.5,23.5,1427,1447,1543,1197,1053,1347,4746
93458,20127,59789,6325,5151,5964,5167,10.6,8.6,10.0,33.7,3191,2464,2912,3134,2687,3052,10246
93460,1163,6280,201,379,411,446,3.2,6.0,6.5,18.5,69,165,154,132,214,257,661
93461,312,1369,39,50,145,148,2.8,3.7,10.6,22.8,15,31,69,24,19,76,162
93463,1310,8059,232,427,389,429,2.9,5.3,4.8,16.3,123,133,166,109,294,223,702
93465,2184,9829,237,701,903,554,2.4,7.1,9.2,22.2,97,253,380,140,448,523,1296
93501,1391,5404,334,399,479,226,6.2,7.4,8.9,25.7,86,135,385,248,264,94,706
93505,3467,14952,850,1071,1084,1046,5.7,7.2,7.2,23.2,266,297,671,584,774,413,2003
93510,1370,7397,357,383,432,327,4.8,5.2,5.8,18.5,178,95,274,179,288,158,753
93512,16,313,0,5,7,4,0.0,1.6,2.2,5.1,0,4,5,0,1,2,4
93513,299,1649,74,68,92,75,4.5,4.1,5.6,18.1,45,37,75,29,31,17,84
93514,2991,14692,698,990,885,670,4.8,6.7,6.0,20.4,340,335,557,358,655,328,1479
93516,644,2583,135,205,201,159,5.2,7.9,7.8,24.9,55,133,131,80,72,70,283
93517,35,587,6,29,0,16,1.0,4.9,0.0,6.0,0,29,0,6,0,0,6
93518,102,894,7,19,46,53,0.8,2.1,5.1,11.4,7,6,14,0,13,32,57
93519,0,0,0,0,0,0,,,,,0,0,0,0,0,0,0
93522,0,86,0,0,0,0,0.0,0.0,0.0,0.0,0,0,0,0,0,0,0
93523,1540,3867,607,434,385,157,15.7,11.2,10.0,39.8,376,255,269,231,179,116,555
93524,0,93,0,0,0,14,0.0,0.0,0.0,0.0,0,0,0,0,0,0,0
93526,215,855,73,37,55,69,8.5,4.3,6.4,25.1,32,29,32,41,8,23,84
93527,368,1734,80,92,39,157,4.6,5.3,2.2,21.2,31,66,22,49,26,17,205
93528,0,94,0,0,0,0,0.0,0.0,0.0,0.0,0,0,0,0,0,0,0
93529,17,302,17,0,0,0,5.6,0.0,0.0,5.6,17,0,0,0,0,0,0
93530,0,28,0,0,0,0,0.0,0.0,0.0,0.0,0,0,0,0,0,0,0
93531,43,425,0,0,29,14,0.0,0.0,6.8,10.1,0,0,29,0,0,0,0
93532,520,2768,169,156,97,201,6.1,5.6,3.5,18.8,98,64,97,71,92,0,194
93534,11883,42515,3254,2799,4104,2686,7.7,6.6,9.7,28.0,1615,1752,2156,1639,1047,1948,5449
93535,24534,80905,4384,7359,8620,7074,5.4,9.1,10.7,30.3,2450,3819,4234,1934,3540,4386,11727
93536,16992,72131,4687,3433,5674,5433,6.5,4.8,7.9,23.6,2274,1583,3127,2413,1850,2547,8448
93541,298,817,0,102,143,53,0.0,12.5,17.5,36.5,0,0,143,0,102,0,102
93543,3559,12745,828,937,1325,812,6.5,7.4,10.4,27.9,441,354,629,387,583,696,1876
93544,178,1427,54,67,29,28,3.8,4.7,2.0,12.5,54,22,29,0,45,0,67
93545,391,1342,139,79,129,45,10.4,5.9,9.6,29.1,78,10,75,61,69,54,187
93546,1833,8689,417,358,613,619,4.8,4.1,7.1,21.1,351,102,452,66,256,161,733
93549,0,254,0,0,0,0,0.0,0.0,0.0,0.0,0,0,0,0,0,0,0
93550,24358,81501,6373,6475,7687,6466,7.8,7.9,9.4,29.9,2942,3354,3866,3431,3121,3821,12173
93551,13948,54478,3505,3769,4178,3746,6.4,6.9,7.7,25.6,1821,1744,2294,1684,2025,1884,6779
93552,12668,43371,2508,3350,4014,4084,5.8,7.7,9.3,29.2,1325,1825,2341,1183,1525,1673,5470
93553,96,1136,38,20,29,77,3.3,1.8,2.6,8.5,23,0,10,15,20,19,63
93554,0,65,0,0,0,0,0.0,0.0,0.0,0.0,0,0,0,0,0,0,0
93555,8700,33490,2402,2341,2596,2290,7.2,7.0,7.8,26.0,1033,829,1058,1369,1512,1538,5110
93558,0,17,0,0,0,0,0.0,0.0,0.0,0.0,0,0,0,0,0,0,0
93560,6279,21300,1281,1959,1725,1939,6.0,9.2,8.1,29.5,719,1226,822,562,733,903,3042
93561,7205,31060,1842,2272,2138,1696,5.9,7.3,6.9,23.2,921,1096,1240,921,1176,898,3506
93562,559,1867,115,193,169,129,6.2,10.3,9.1,29.9,82,98,118,33,95,51,192
93563,72,222,47,25,0,0,21.2,11.3,0.0,32.4,0,25,0,47,0,0,47
93581,0,3611,0,0,0,11,0.0,0.0,0.0,0.0,0,0,0,0,0,0,0
93591,2345,7340,667,478,770,632,9.1,6.5,10.5,31.9,196,250,272,471,228,498,1251
93601,103,1206,31,0,40,47,2.6,0.0,3.3,8.5,31,0,6,0,0,34,66
93602,518,3038,72,174,170,148,2.4,5.7,5.6,17.1,35,109,72,37,65,98,264
93603,0,249,0,0,0,7,0.0,0.0,0.0,0.0,0,0,0,0,0,0,0
93604,49,366,0,32,0,17,0.0,8.7,0.0,13.4,0,13,0,0,19,0,27
93605,36,97,0,15,17,7,0.0,15.5,17.5,37.1,0,15,13,0,0,4,8
93606,406,1129,154,104,73,133,13.6,9.2,6.5,36.0,46,56,42,108,48,31,219
93608,289,1018,58,90,116,31,5.7,8.8,11.4,28.4,29,23,72,29,67,44,146
93609,1298,4889,227,340,364,592,4.6,7.0,7.4,26.5,159,222,253,68,118,111,479
93610,5470,23795,1515,1750,1254,1564,6.4,7.4,5.3,23.0,727,949,912,788,801,342,2489
93611,12296,46620,2812,3205,4066,3389,6.0,6.9,8.7,26.4,1222,1543,1946,1590,1662,2120,6639
93612,10081,37138,2422,2841,3062,2601,6.5,7.6,8.2,27.1,1179,1708,1679,1243,1133,1383,4493
93614,2542,11760,650,646,859,533,5.5,5.5,7.3,21.6,270,330,434,380,316,425,1331
93615,1932,5767,391,672,528,555,6.8,11.7,9.2,33.5,299,424,249,92,248,279,853
93616,637,2163,150,134,231,224,6.9,6.2,10.7,29.4,98,80,138,52,54,93,256
93618,10842,32334,2544,2830,3708,3034,7.9,8.8,11.5,33.5,1579,1388,2375,965,1442,1333,4789
93619,15693,50848,3544,4631,5152,3278,7.0,9.1,10.1,30.9,1965,2408,2788,1579,2223,2364,7372
93620,2189,9363,586,387,732,871,6.3,4.1,7.8,23.4,321,229,169,265,158,563,1378
93621,0,173,0,0,0,0,0.0,0.0,0.0,0.0,0,0,0,0,0,0,0
93622,3269,9419,710,984,929,1003,7.5,10.4,9.9,34.7,430,404,477,280,580,452,1825
93623,0,4,0,0,0,0,0.0,0.0,0.0,0.0,0,0,0,0,0,0,0
93624,249,892,29,43,77,132,3.3,4.8,8.6,27.9,9,25,32,20,18,45,121
93625,2501,8396,570,755,667,773,6.8,9.0,7.9,29.8,288,501,215,282,254,452,1281
93626,651,2583,148,96,217,217,5.7,3.7,8.4,25.2,122,70,85,26,26,132,198
93627,110,196,14,6,28,62,7.1,3.1,14.3,56.1,0,0,0,14,6,28,110
93628,0,310,0,0,0,0,0.0,0.0,0.0,0.0,0,0,0,0,0,0,0
93630,6555,20272,1420,1652,2148,1955,7.0,8.1,10.6,32.3,666,889,1006,754,763,1142,3388
93631,4209,16588,869,1190,1128,1415,5.2,7.2,6.8,25.4,284,696,575,585,494,553,2195
93633,0,26,0,0,0,0,0.0,0.0,0.0,0.0,0,0,0,0,0,0,0
93634,0,29,0,0,0,4,0.0,0.0,0.0,0.0,0,0,0,0,0,0,0
93635,16245,47683,4364,4214,5008,4188,9.2,8.8,10.5,34.1,1887,1764,2539,2477,2450,2469,8405
93636,3435,13447,773,981,1156,736,5.7,7.3,8.6,25.5,452,602,583,321,379,573,1457
93637,12756,41324,3246,3520,3941,3363,7.9,8.5,9.5,30.9,1694,1499,1983,1552,2021,1958,6262
93638,16330,51724,4148,4474,4734,4690,8.0,8.6,9.2,31.6,2290,2372,2353,1858,2102,2381,8064
93640,5010,14162,1282,1454,1634,1109,9.1,10.3,11.5,35.4,604,932,907,678,522,727,2200
93641,27,216,14,0,13,0,6.5,0.0,6.0,12.5,14,0,13,0,0,0,0
93643,422,3115,61,89,184,143,2.0,2.9,5.9,13.5,61,52,146,0,37,38,127
93644,1208,7169,317,217,460,280,4.4,3.0,6.4,16.9,103,40,223,214,177,237,702
93645,203,897,0,98,17,257,0.0,10.9,1.9,22.6,0,39,0,0,59,17,97
93646,3701,10157,846,997,1163,1078,8.3,9.8,11.5,36.4,420,586,629,426,411,534,1624
93647,4003,11828,1163,1086,1131,928,9.8,9.2,9.6,33.8,632,522,598,531,564,533,1895
93648,4852,15370,1143,1261,1427,1598,7.4,8.2,9.3,31.6,521,649,731,622,612,696,2503
93650,660,2844,171,109,220,381,6.0,3.8,7.7,23.2,101,85,101,70,24,119,321
93651,364,1580,256,84,11,93,16.2,5.3,0.7,23.0,179,26,0,77,58,11,146
93652,66,378,36,7,16,22,9.5,1.9,4.2,17.5,16,0,10,20,7,6,37
93653,254,1378,31,29,83,142,2.2,2.1,6.0,18.4,12,14,30,19,15,53,141
93654,8818,30476,2495,2358,2376,2726,8.2,7.7,7.8,28.9,991,1213,1156,1504,1145,1220,4612
93656,1624,6249,427,485,469,562,6.8,7.8,7.5,26.0,222,98,259,205,387,210,926
93657,10036,36053,2787,3038,2447,2572,7.7,8.4,6.8,27.8,1430,1454,1124,1357,1584,1323,5064
93660,1444,3921,433,394,386,378,11.0,10.0,9.8,36.8,168,176,218,265,218,168,800
93662,7905,30191,1996,2192,2172,2465,6.6,7.3,7.2,26.2,931,1096,1110,1065,1096,1062,3897
93664,9,288,0,0,3,9,0.0,0.0,1.0,3.1,0,0,3,0,0,0,0
93665,40,386,0,0,0,75,0.0,0.0,0.0,10.4,0,0,0,0,0,0,40
93666,272,704,52,92,93,61,7.4,13.1,13.2,38.6,34,64,52,18,28,41,116
93667,328,1909,71,86,125,58,3.7,4.5,6.5,17.2,21,44,62,50,42,63,196
93668,271,1025,71,36,71,122,6.9,3.5,6.9,26.4,53,17,40,18,19,31,103
93669,54,324,0,21,31,2,0.0,6.5,9.6,16.7,0,21,0,0,0,31,33
93670,0,108,0,0,0,0,0.0,0.0,0.0,0.0,0,0,0,0,0,0,0
93673,74,378,30,21,21,16,7.9,5.6,5.6,19.6,8,11,19,22,10,2,36
93675,1587,4891,331,516,457,465,6.8,10.5,9.3,32.4,185,295,265,146,221,192,753
93701,2978,10602,565,946,999,771,5.3,8.9,9.4,28.1,213,446,582,352,500,417,1475
93702,14483,45248,3352,3921,4952,4272,7.4,8.7,10.9,32.0,1741,2095,2464,1611,1826,2488,6919
93703,9601,32603,2710,2546,2665,2809,8.3,7.8,8.2,29.4,1278,1274,1623,1432,1272,1042,4452
93704,7670,29502,1966,2096,2542,1467,6.7,7.1,8.6,26.0,921,1120,1087,1045,976,1455,3985
93705,11677,38777,3614,3039,3374,3151,9.3,7.8,8.7,30.1,1915,1252,1732,1699,1787,1642,5777
93706,13081,41523,3333,3419,3770,3795,8.0,8.2,9.1,31.5,1999,1796,1971,1334,1623,1799,6100
93710,6737,32730,1945,1839,1872,2716,5.9,5.6,5.7,20.6,811,734,973,1134,1105,899,3722
93711,8590,39963,2467,2647,2382,1759,6.2,6.6,6.0,21.5,1239,1243,1292,1228,1404,1090,4244
93720,10956,48597,2695,3633,2785,2649,5.5,7.5,5.7,22.5,1509,1950,1499,1186,1683,1286,5092
93721,1068,8004,278,346,275,293,3.5,4.3,3.4,13.3,175,251,128,103,95,147,422
93722,24263,86387,6367,6586,7447,6250,7.4,7.6,8.6,28.1,3463,3676,3524,2904,2910,3923,11673
93723,4094,13174,1215,1147,1040,1059,9.2,8.7,7.9,31.1,596,586,603,619,561,437,1910
93725,8359,26568,1976,2493,2625,2081,7.4,9.4,9.9,31.5,1118,1645,1243,858,848,1382,3700
93726,12099,44790,3426,3575,3343,2975,7.6,8.0,7.5,27.0,1923,1909,1860,1503,1666,1483,5449
93727,25530,82176,7515,6996,7480,5633,9.1,8.5,9.1,31.1,3897,3413,3651,3618,3583,3829,12596
93728,4444,17892,1424,1225,1129,1102,8.0,6.8,6.3,24.8,870,343,703,554,882,426,2168
93730,3174,12461,499,684,1366,905,4.0,5.5,11.0,25.5,263,373,675,236,311,691,1545
93737,1923,6624,554,426,661,409,8.4,6.4,10.0,29.0,221,159,384,333,267,277,979
93740,22,1174,0,0,0,620,0.0,0.0,0.0,1.9,0,0,0,0,0,0,20
93741,2,77,0,0,1,2,0.0,0.0,1.3,2.6,0,0,1,0,0,0,0
93901,7467,29498,2323,2198,1776,1834,7.9,7.5,6.0,25.3,1009,1348,900,1314,850,876,3515
93905,21398,63121,5171,6109,6587,5996,8.2,9.7,10.4,33.9,2656,3176,3742,2515,2933,2845,9710
93906,18816,66883,5454,4504,5798,5305,8.2,6.7,8.7,28.1,2881,2284,3081,2573,2220,2717,9070
93907,6251,25124,1240,1684,2209,2027,4.9,6.7,8.8,24.9,558,944,1044,682,740,1165,3251
93908,3412,12983,514,1202,1044,1030,4.0,9.3,8.0,26.3,246,559,420,268,643,624,1838
93920,409,1790,80,232,77,116,4.5,13.0,4.3,22.8,4,125,4,76,107,73,259
93921,259,2469,54,27,162,31,2.2,1.1,6.6,10.5,0,27,77,54,0,85,139
93923,2032,12630,388,466,633,682,3.1,3.7,5.0,16.1,86,260,392,302,206,241,1029
93924,1140,6563,88,480,354,321,1.3,7.3,5.4,17.4,34,306,136,54,174,218,567
93925,467,1352,66,168,152,133,4.9,12.4,11.2,34.5,47,82,109,19,86,43,177
93926,2437,8941,729,704,605,767,8.2,7.9,6.8,27.3,186,326,399,543,378,206,1369
93927,7254,19983,2123,1829,2056,1883,10.6,9.2,10.3,36.3,1051,755,980,1072,1074,1076,3908
93928,28,1040,0,0,0,169,0.0,0.0,0.0,2.7,0,0,0,0,0,0,0
93930,5473,16807,1592,1578,1210,1629,9.5,9.4,7.2,32.6,956,559,532,636,1019,678,2895
93932,15,370,0,0,7,8,0.0,0.0,1.9,4.1,0,0,0,0,0,7,7
93933,6067,27197,1638,1758,1724,1697,6.0,6.5,6.3,22.3,960,1054,925,678,704,799,2758
93940,4598,31513,1745,1049,1203,950,5.5,3.3,3.8,14.6,905,573,525,840,476,678,2357
93943,0,12,0,0,0,0,0.0,0.0,0.0,0.0,0,0,0,0,0,0,0
93944,107,2605,0,0,0,664,0.0,0.0,0.0,4.1,0,0,0,0,0,0,0
93950,2585,15098,545,859,737,562,3.6,5.7,4.9,17.1,203,372,257,342,487,480,1565
93953,482,3416,123,115,164,128,3.6,3.4,4.8,14.1,36,81,76,87,34,88,251
93954,189,501,36,51,68,62,7.2,10.2,13.6,37.7,0,16,40,36,35,28,110
93955,7241,32610,1843,2153,1936,2768,5.7,6.6,5.9,22.2,1175,1086,875,668,1067,1061,3332
93960,6453,26037,1186,1572,2582,2009,4.6,6.0,9.9,24.8,748,1117,1224,438,455,1358,2840
93962,0,198,0,0,0,0,0.0,0.0,0.0,0.0,0,0,0,0,0,0,0
94002,6395,27893,1429,1578,1943,1971,5.1,5.7,7.0,22.9,744,995,1136,685,583,807,2628
94005,959,4756,275,356,229,236,5.8,7.5,4.8,20.2,159,191,96,116,165,133,497
94010,10367,43458,2264,3021,3228,2449,5.2,7.0,7.4,23.9,1300,1786,1806,964,1235,1422,4488
94014,6909,46331,1611,1558,2027,2644,3.5,3.4,4.4,14.9,811,860,935,800,698,1092,3613
94015,10292,65125,3339,2997,2407,3173,5.1,4.6,3.7,15.8,1446,1554,1054,1893,1443,1353,5535
94018,589,3423,78,80,273,250,2.3,2.3,8.0,17.2,44,80,144,34,0,129,253
94019,2832,15275,777,675,983,749,5.1,4.4,6.4,18.5,421,311,404,356,364,579,1542
94020,339,2030,136,140,45,40,6.7,6.9,2.2,16.7,91,44,11,45,96,34,188
94021,34,123,0,0,34,0,0.0,0.0,27.6,27.6,0,0,34,0,0,0,0
94022,4515,20052,855,1078,1593,1265,4.3,5.4,7.9,22.5,388,532,818,467,546,775,2369
94024,5901,24041,962,1673,1977,1866,4.0,7.0,8.2,24.5,514,884,1109,448,789,868,2649
94025,9500,41017,2748,3015,2450,2117,6.7,7.4,6.0,23.2,1590,1453,1063,1158,1562,1387,4856
94027,1419,7142,123,219,644,870,1.7,3.1,9.0,19.9,85,130,315,38,89,329,611
94028,1089,6888,318,324,231,378,4.6,4.7,3.4,15.8,114,119,209,204,205,22,605
94030,4319,22825,1266,987,1177,1346,5.5,4.3,5.2,18.9,696,545,661,570,442,516,2056
94037,154,2649,116,32,0,67,4.4,1.2,0.0,5.8,0,32,0,116,0,0,116
94038,776,3165,213,131,157,312,6.7,4.1,5.0,24.5,150,93,157,63,38,0,317
94040,7714,35667,2086,2338,1904,2119,5.8,6.6,5.3,21.6,844,1144,1074,1242,1194,830,3890
94041,3258,15222,1233,932,705,653,8.1,6.1,4.6,21.4,703,472,360,530,460,345,1513
94043,6522,32670,2118,1595,1835,1345,6.5,4.9,5.6,20.0,1003,864,886,1115,731,949,3280
94044,7338,38061,1933,1942,2109,2194,5.1,5.1,5.5,19.3,890,805,1185,1043,1137,924,3646
94060,145,1312,54,45,32,30,4.1,3.4,2.4,11.1,54,31,32,0,14,0,28
94061,8000,37539,2293,1898,2158,2434,6.1,5.1,5.7,21.3,1131,1045,1221,1162,853,937,3590
94062,5722,26531,1213,1474,2085,1368,4.6,5.6,7.9,21.6,676,714,1110,537,760,975,2777
94063,7779,34807,1984,2352,2207,2035,5.7,6.8,6.3,22.3,869,1218,1072,1115,1134,1135,4001
94065,2697,11588,729,819,800,501,6.3,7.1,6.9,23.3,349,344,399,380,475,401,1456
94066,8111,43369,2048,2527,2351,2079,4.7,5.8,5.4,18.7,1062,1426,1188,986,1101,1163,3811
94070,7328,31312,1654,2110,2162,1796,5.3,6.7,6.9,23.4,817,1071,1111,837,1039,1051,3531
94074,48,151,19,0,29,0,12.6,0.0,19.2,31.8,19,0,29,0,0,0,0
94080,11389,66262,2960,3400,3114,3607,4.5,5.1,4.7,17.2,1716,1894,1323,1244,1506,1791,5477
94085,3946,22996,1584,1104,715,809,6.9,4.8,3.1,17.2,843,468,445,741,636,270,1920
94086,9214,49217,3931,2206,2013,1430,8.0,4.5,4.1,18.7,1962,1120,995,1969,1086,1018,4560
94087,14312,58913,3645,4063,4605,2741,6.2,6.9,7.8,24.3,2220,1901,2425,1425,2162,2180,6780
94089,3322,23447,1164,947,748,728,5.0,4.0,3.2,14.2,727,587,283,437,360,465,1502
94102,3252,34077,1044,723,1057,949,3.1,2.1,3.1,9.5,513,290,372,531,433,685,1852
94103,3031,32400,984,930,688,590,3.0,2.9,2.1,9.4,720,558,446,264,372,242,1061
94104,52,557,0,7,31,36,0.0,1.3,5.6,9.3,0,7,16,0,0,15,29
94105,624,13722,402,41,57,196,2.9,0.3,0.4,4.5,298,14,22,104,27,35,166
94107,2854,30340,1210,877,503,721,4.0,2.9,1.7,9.4,463,414,275,747,463,228,1654
94108,1130,12070,284,300,302,413,2.4,2.5,2.5,9.4,150,165,202,134,135,100,554
94109,3574,56333,1557,658,900,989,2.8,1.2,1.6,6.3,714,368,435,843,290,465,1764
94110,10330,69679,3492,3056,2619,1665,5.0,4.4,3.8,14.8,1923,1558,1472,1569,1498,1147,4765
94111,476,4468,140,196,45,190,3.1,4.4,1.0,10.7,71,161,25,69,35,20,139
94112,13781,80880,3240,3948,4104,3548,4.0,4.9,5.1,17.0,1627,1973,1981,1613,1975,2123,7190
94114,3813,33858,1147,1200,1102,490,3.4,3.5,3.3,11.3,622,439,574,525,761,528,1972
94115,3558,33299,1307,742,961,938,3.9,2.2,2.9,10.7,732,359,669,575,383,292,1515
94116,7428,43903,2148,2445,1968,1341,4.9,5.6,4.5,16.9,979,1514,969,1169,931,999,3579
94117,4162,39496,1724,1182,762,845,4.4,3.0,1.9,10.5,892,531,320,832,651,442,2168
94118,5650,40108,1813,1351,1475,2482,4.5,3.4,3.7,14.1,993,621,889,820,730,586,2657
94121,7048,43304,2259,1601,1915,1787,5.2,3.7,4.4,16.3,1215,952,742,1044,649,1173,3669
94122,8580,59453,2854,2235,2139,2096,4.8,3.8,3.6,14.4,1305,1125,1031,1549,1110,1108,4397
94123,3251,24721,1457,603,697,603,5.9,2.4,2.8,13.2,680,247,355,777,356,342,1707
94124,8541,37347,2324,2145,2408,2522,6.2,5.7,6.4,22.9,1291,1128,1219,1033,1017,1189,3825
94127,3704,21184,803,917,1417,714,3.8,4.3,6.7,17.5,300,520,747,503,397,670,1827
94128,0,0,0,0,0,0,,,,,0,0,0,0,0,0,0
94129,1011,3952,478,257,239,103,12.1,6.5,6.0,25.6,310,76,173,168,181,66,430
94130,496,3136,96,106,137,330,3.1,3.4,4.4,15.8,66,69,95,30,37,42,134
94131,4678,28705,1452,1416,1283,906,5.1,4.9,4.5,16.3,767,641,663,685,775,620,2380
94132,3310,27641,592,889,1031,3027,2.1,3.2,3.7,12.0,225,564,511,367,325,520,1571
94133,2667,25460,1104,433,760,657,4.3,1.7,3.0,10.5,536,241,485,568,192,275,1212
94134,6546,40738,1609,1585,2309,1614,3.9,3.9,5.7,16.1,784,729,1304,825,856,1005,3217
94158,1855,10205,1057,401,238,308,10.4,3.9,2.3,18.2,427,163,47,630,238,191,1127
94188,0,0,0,0,0,0,,,,,0,0,0,0,0,0,0
94301,3314,17259,509,756,1167,1254,2.9,4.4,6.8,19.2,261,400,531,248,356,636,1732
94303,11719,47989,2803,2854,3465,3937,5.8,5.9,7.2,24.4,1316,1500,1795,1487,1354,1670,5655
94304,771,4489,285,240,151,140,6.3,5.3,3.4,17.2,90,134,44,195,106,107,456
94305,1117,17279,310,195,288,4963,1.8,1.1,1.7,6.5,144,77,136,166,118,152,571
94306,6178,27785,1363,1522,2049,1718,4.9,5.5,7.4,22.2,525,887,954,838,635,1095,3167
94401,6636,35392,2155,2045,1537,1774,6.1,5.8,4.3,18.8,1177,1234,603,978,811,934,3115
94402,5849,26150,1534,1511,1762,1458,5.9,5.8,6.7,22.4,834,483,893,700,1028,869,3174
94403,8526,43858,2504,1942,2789,1779,5.7,4.4,6.4,19.4,1366,1004,1592,1138,938,1197,3912
94404,7872,36397,2256,2270,2094,1662,6.2,6.2,5.8,21.6,1067,1142,1046,1189,1128,1048,3895
94501,13453,63340,4139,3589,3842,2765,6.5,5.7,6.1,21.2,2210,1920,1757,1929,1669,2085,6505
94502,3117,14225,637,1159,758,563,4.5,8.1,5.3,21.9,425,623,437,212,536,321,1324
94503,5524,21791,1146,1301,1956,1680,5.3,6.0,9.0,25.3,535,653,899,611,648,1057,2833
94505,3405,15445,936,860,904,1227,6.1,5.6,5.9,22.0,685,353,501,251,507,403,1516
94506,6616,26947,1126,1370,2612,2187,4.2,5.1,9.7,24.6,672,616,945,454,754,1667,3475
94507,3112,14503,464,765,1045,1104,3.2,5.3,7.2,21.5,258,406,562,206,359,483,1482
94508,514,3406,114,115,159,636,3.3,3.4,4.7,15.1,55,51,110,59,64,49,230
94509,17605,70889,4647,4463,4943,5360,6.6,6.3,7.0,24.8,2343,2004,1992,2304,2459,2951,9697
94510,5575,27223,1361,1603,1545,1622,5.0,5.9,5.7,20.5,764,915,797,597,688,748,2588
94511,299,1993,0,51,221,100,0.0,2.6,11.1,15.0,0,0,148,0,51,73,124
94512,0,57,0,0,0,0,0.0,0.0,0.0,0.0,0,0,0,0,0,0,0
94513,17035,67580,2267,4752,6021,6368,3.4,7.0,8.9,25.2,1182,2466,2629,1085,2286,3392,8775
94514,438,2023,49,100,182,256,2.4,4.9,9.0,21.7,35,27,121,14,73,61,148
94515,941,7024,340,162,204,340,4.8,2.3,2.9,13.4,208,59,118,132,103,86,419
94516,30,212,24,0,4,2,11.3,0.0,1.9,14.2,0,0,3,24,0,1,25
94517,2814,12349,452,746,960,1061,3.7,6.0,7.8,22.8,279,484,531,173,262,429,1230
94518,5712,28287,1913,1639,1251,1479,6.8,5.8,4.4,20.2,959,932,553,954,707,698,2795
94519,4308,20162,1117,1357,1223,924,5.5,6.7,6.1,21.4,627,540,816,490,817,407,2064
94520,8224,36699,3117,1841,2028,2246,8.5,5.0,5.5,22.4,1549,920,1135,1568,921,893,3993
94521,7519,41092,2348,2096,1947,2069,5.7,5.1,4.7,18.3,1110,1202,991,1238,894,956,3650
94523,6870,34964,1754,1731,1893,2396,5.0,5.0,5.4,19.6,893,922,1093,861,809,800,3132
94525,498,3599,65,161,68,276,1.8,4.5,1.9,13.8,24,74,40,41,87,28,288
94526,8270,33396,1293,2186,2787,3113,3.9,6.5,8.3,24.8,698,1300,1499,595,886,1288,3665
94528,231,726,79,134,0,63,10.9,18.5,0.0,31.8,12,72,0,67,62,0,129
94530,4669,26483,1509,1281,1204,974,5.7,4.8,4.5,17.6,575,735,680,934,546,524,2375
94531,9739,44115,2450,2551,2751,3190,5.6,5.8,6.2,22.1,1351,1120,1275,1099,1431,1476,5062
94533,19021,78129,5396,4693,5491,5208,6.9,6.0,7.0,24.3,2305,2514,2494,3091,2179,2997,9982
94534,9441,41395,2608,2549,2841,2598,6.3,6.2,6.9,22.8,1561,1328,1594,1047,1221,1247,4465
94535,1478,3873,685,416,291,159,17.7,10.7,7.5,38.2,381,221,161,304,195,130,688
94536,15836,71445,4707,5021,4227,3163,6.6,7.0,5.9,22.2,2626,2101,2094,2081,2920,2133,8044
94538,13861,66215,3855,3837,3902,3445,5.8,5.8,5.9,20.9,1887,1723,2115,1968,2114,1787,7061
94539,12828,53464,2672,3423,3957,3663,5.0,6.4,7.4,24.0,1035,1724,2194,1637,1699,1763,6387
94541,14128,67401,4071,3762,3698,4005,6.0,5.6,5.5,21.0,2413,2070,1881,1658,1692,1817,6513
94542,2550,16188,653,540,887,1751,4.0,3.3,5.5,15.8,422,215,506,231,325,381,1134
94544,16392,77712,4036,4041,5208,4638,5.2,5.2,6.7,21.1,2111,2045,2797,1925,1996,2411,7554
94545,5773,33700,1895,1559,1415,1485,5.6,4.6,4.2,17.1,1198,879,663,697,680,752,2470
94546,9754,45761,2347,3070,2407,2621,5.1,6.7,5.3,21.3,1198,1590,1426,1149,1480,981,4456
94547,5152,26041,1108,1728,1656,1240,4.3,6.6,6.4,19.8,569,805,775,539,923,881,2595
94548,238,598,134,46,11,73,22.4,7.7,1.8,39.8,86,5,5,48,41,6,136
94549,6808,28456,1205,2176,2213,1671,4.2,7.6,7.8,23.9,438,1370,1084,767,806,1129,3440
94550,10789,49463,2731,3005,3067,3019,5.5,6.1,6.2,21.8,1425,1488,1286,1306,1517,1781,5541
94551,9346,40025,3180,2582,2500,2073,7.9,6.5,6.2,23.4,1843,1229,888,1337,1353,1612,4870
94552,3039,14948,515,720,1114,936,3.4,4.8,7.5,20.3,267,329,500,248,391,614,1627
94553,10043,49062,3159,2879,2650,2090,6.4,5.9,5.4,20.5,1589,1619,1415,1570,1260,1235,4537
94555,10033,37671,2138,3429,3163,1830,5.7,9.1,8.4,26.6,877,1810,1642,1261,1619,1521,5055
94556,3516,15959,737,883,1260,1242,4.6,5.5,7.9,22.0,433,506,603,304,377,657,1686
94558,12574,65084,2705,2971,4482,3888,4.2,4.6,6.9,19.3,1344,1687,2128,1361,1284,2354,6191
94559,6332,28224,1659,1436,2050,1836,5.9,5.1,7.3,22.4,874,842,1055,785,594,995,2924
94560,9354,47470,3079,2500,2171,2706,6.5,5.3,4.6,19.7,1463,1204,1128,1616,1296,1043,4744
94561,11230,44546,3342,3039,3257,2789,7.5,6.8,7.3,25.2,1587,1792,1699,1755,1247,1558,5246
94562,0,0,0,0,0,0,,,,,0,0,0,0,0,0,0
94563,4760,19416,917,1209,1528,1437,4.7,6.2,7.9,24.5,410,695,660,507,514,868,2648
94564,3340,18946,973,820,1022,868,5.1,4.3,5.4,17.6,407,309,558,566,511,464,1659
94565,23560,100826,6901,6162,6786,6155,6.8,6.1,6.7,23.4,3531,3401,3968,3370,2761,2818,10863
94566,10362,45145,1748,2689,3833,3243,3.9,6.0,8.5,23.0,1032,1248,1866,716,1441,1967,5206
94567,201,719,35,59,58,49,4.9,8.2,8.1,28.0,22,18,3,13,41,55,142
94568,18519,71068,4983,6060,4904,3553,7.0,8.5,6.9,26.1,2543,3253,2561,2440,2807,2343,8920
94569,0,251,0,0,0,0,0.0,0.0,0.0,0.0,0,0,0,0,0,0,0
94571,742,10514,233,218,173,138,2.2,2.1,1.6,7.1,123,111,117,110,107,56,367
94572,1927,9309,551,511,467,617,5.9,5.5,5.0,20.7,163,205,205,388,306,262,1106
94573,17,107,0,0,17,0,0.0,0.0,15.9,15.9,0,0,17,0,0,0,0
94574,1180,7827,308,335,264,370,3.9,4.3,3.4,15.1,168,173,149,140,162,115,558
94575,0,1048,0,0,0,477,0.0,0.0,0.0,0.0,0,0,0,0,0,0,0
94576,29,171,0,29,0,0,0.0,17.0,0.0,17.0,0,0,0,0,29,0,29
94577,8534,47937,2283,2085,2271,2830,4.8,4.3,4.7,17.8,1241,1297,1278,1042,788,993,3813
94578,8513,42350,2297,2499,2367,2677,5.4,5.9,5.6,20.1,1046,1146,1011,1251,1353,1356,4763
94579,3088,20272,561,1037,832,1185,2.8,5.1,4.1,15.2,290,571,517,271,466,315,1360
94580,5395,29377,1431,1452,1532,1819,4.9,4.9,5.2,18.4,662,708,801,769,744,731,2814
94582,13407,47338,2196,3483,5112,3547,4.6,7.4,10.8,28.3,813,1484,2608,1383,1999,2504,7202
94583,10185,39758,2205,2739,3306,2787,5.5,6.9,8.3,25.6,1292,1253,1976,913,1486,1330,4482
94585,7042,29401,1608,1904,2333,2005,5.5,6.5,7.9,24.0,878,1177,1427,730,727,906,2979
94586,227,964,46,104,39,42,4.8,10.8,4.0,23.5,29,43,23,17,61,16,109
94587,12274,69502,3213,3347,3761,3476,4.6,4.8,5.4,17.7,1939,1782,2089,1274,1565,1672,5497
94588,8388,35162,1866,2221,2761,2203,5.3,6.3,7.9,23.9,714,1259,1323,1152,962,1438,4221
94589,6562,29959,1549,1925,1944,1774,5.2,6.4,6.5,21.9,862,784,948,687,1141,996,3381
94590,7220,37991,1959,1888,2389,1862,5.2,5.0,6.3,19.0,1059,993,1057,900,895,1332,3666
94591,11949,59026,2887,3230,3505,3742,4.9,5.5,5.9,20.2,1344,1637,2138,1543,1593,1367,5733
94592,75,1020,32,28,15,0,3.1,2.7,1.5,7.4,14,15,15,18,13,0,31
94595,1849,17341,542,484,477,410,3.1,2.8,2.8,10.7,242,134,242,300,350,235,1036
94596,3772,23795,1062,1003,895,1211,4.5,4.2,3.8,15.9,539,477,500,523,526,395,1937
94597,3965,23654,1355,1113,727,1052,5.7,4.7,3.1,16.8,872,526,383,483,587,344,1873
94598,5048,26346,1325,1526,1403,1129,5.0,5.8,5.3,19.2,652,719,825,673,807,578,2317
94599,181,3428,34,92,22,49,1.0,2.7,0.6,5.3,34,82,0,0,10,22,46
94601,11837,52102,3049,3108,3569,3291,5.9,6.0,6.9,22.7,1570,1588,1786,1479,1520,1783,5870
94602,5620,31104,1946,1539,1501,1284,6.3,4.9,4.8,18.1,1236,699,740,710,840,761,2585
94603,9965,37042,2877,2510,3124,2534,7.8,6.8,8.4,26.9,1348,1305,1670,1529,1205,1454,4921
94605,8747,44477,2712,2359,2245,2248,6.1,5.3,5.0,19.7,1171,1453,1142,1541,906,1103,4348
94606,6362,38459,1553,1702,2022,1640,4.0,4.4,5.3,16.5,732,869,918,821,833,1104,3271
94607,4085,27019,1007,1403,987,1053,3.7,5.2,3.7,15.1,524,763,600,483,640,387,1721
94608,4261,34083,1625,999,1222,621,4.8,2.9,3.6,12.5,770,540,709,855,459,513,1993
94609,3691,25175,1365,967,903,974,5.4,3.8,3.6,14.7,503,468,484,862,499,419,1982
94610,5051,32404,1753,1284,1225,981,5.4,4.0,3.8,15.6,809,790,709,944,494,516,2394
94611,6934,39780,2086,1833,1774,1788,5.2,4.6,4.5,17.4,874,1137,756,1212,696,1018,3550
94612,1528,17742,447,382,473,434,2.5,2.2,2.7,8.6,98,212,115,349,170,358,910
94613,20,612,0,0,0,364,0.0,0.0,0.0,3.3,0,0,0,0,0,0,20
94618,3219,17285,803,868,849,1071,4.6,5.0,4.9,18.6,435,468,464,368,400,385,1415
94619,5986,27018,1964,1805,1508,1346,7.3,6.7,5.6,22.2,962,938,833,1002,867,675,2916
94621,9728,34911,2553,2515,2799,2762,7.3,7.2,8.0,27.9,1109,1367,1467,1444,1148,1332,4849
94702,3434,17473,846,1008,981,955,4.8,5.8,5.6,19.7,357,511,450,489,497,531,1847
94703,2854,20404,545,724,884,1179,2.7,3.5,4.3,14.0,374,440,530,171,284,354,1125
94704,1166,25711,371,281,359,4916,1.4,1.1,1.4,4.5,197,105,260,174,176,99,527
94705,2268,14508,559,788,617,514,3.9,5.4,4.3,15.6,338,330,356,221,458,261,1130
94706,4991,20860,1272,1377,1494,1246,6.1,6.6,7.2,23.9,723,690,799,549,687,695,2433
94707,2329,12596,561,784,614,561,4.5,6.2,4.9,18.5,263,358,360,298,426,254,1102
94708,2044,11810,496,659,518,765,4.2,5.6,4.4,17.3,263,316,225,233,343,293,1119
94709,878,12200,399,147,211,927,3.3,1.2,1.7,7.2,226,92,152,173,55,59,358
94710,1273,8471,333,159,330,577,3.9,1.9,3.9,15.0,191,62,151,142,97,179,743
94720,253,5322,41,12,12,3092,0.8,0.2,0.2,4.8,32,12,0,9,0,12,72
94801,8287,32759,1645,2364,2649,2891,5.0,7.2,8.1,25.3,890,1097,1403,755,1267,1246,4045
94803,4757,27171,966,1630,1431,1052,3.6,6.0,5.3,17.5,523,808,702,443,822,729,2394
94804,10102,44387,2639,2572,2991,3232,5.9,5.8,6.7,22.8,1392,1250,1529,1247,1322,1462,4865
94805,2738,14790,815,866,503,960,5.5,5.9,3.4,18.5,530,398,238,285,468,265,1236
94806,14682,63730,3162,4001,4865,4433,5.0,6.3,7.6,23.0,1708,2353,2573,1454,1648,2292,6676
94901,8336,40927,1865,2378,2637,2626,4.6,5.8,6.4,20.4,1144,1116,1494,721,1262,1143,3919
94903,5044,31582,936,1461,1575,2100,3.0,4.6,5.0,16.0,414,642,990,522,819,585,2366
94904,2725,13132,688,533,1023,727,5.2,4.1,7.8,20.8,331,281,458,357,252,565,1361
94920,2504,12906,381,623,887,891,3.0,4.8,6.9,19.4,152,437,392,229,186,495,1302
94922,158,509,0,0,118,113,0.0,0.0,23.2,31.0,0,0,118,0,0,0,0
94923,129,1390,0,0,16,139,0.0,0.0,1.2,9.3,0,0,0,0,0,16,55
94924,101,1342,40,25,36,0,3.0,1.9,2.7,7.5,24,19,12,16,6,24,46
94925,2581,10155,670,623,964,480,6.6,6.1,9.5,25.4,330,399,394,340,224,570,1320
94928,8906,46231,2763,2693,2061,3574,6.0,5.8,4.5,19.3,1509,1429,773,1254,1264,1288,4743
94929,104,442,72,32,0,0,16.3,7.2,0.0,23.5,36,0,0,36,32,0,68
94930,1584,8748,427,300,501,560,4.9,3.4,5.7,18.1,238,145,230,189,155,271,834
94931,1558,8945,581,495,290,271,6.5,5.5,3.2,17.4,260,160,179,321,335,111,829
94933,192,1284,78,41,57,16,6.1,3.2,4.4,15.0,0,0,29,78,41,28,147
94937,60,938,25,35,0,0,2.7,3.7,0.0,6.4,25,7,0,0,28,0,28
94938,34,428,0,0,13,21,0.0,0.0,3.0,7.9,0,0,13,0,0,0,21
94939,1479,7488,450,298,412,453,6.0,4.0,5.5,19.8,123,136,221,327,162,191,907
94940,41,260,0,0,10,57,0.0,0.0,3.8,15.8,0,0,0,0,0,10,10
94941,7637,32190,1532,1974,2378,2521,4.8,6.1,7.4,23.7,763,967,1038,769,1007,1340,4041
94945,3283,17309,706,672,1169,1018,4.1,3.9,6.8,19.0,455,276,483,251,396,686,1708
94946,75,673,11,18,31,21,1.6,2.7,4.6,11.1,2,7,13,9,11,18,44
94947,4894,25183,1100,1228,1349,1667,4.4,4.9,5.4,19.4,512,762,654,588,466,695,2225
94949,3736,18545,973,1044,1112,915,5.2,5.6,6.0,20.1,459,536,731,514,508,381,1619
94950,0,23,0,0,0,0,0.0,0.0,0.0,0.0,0,0,0,0,0,0,0
94951,765,3574,201,165,262,237,5.6,4.6,7.3,21.4,87,78,125,114,87,137,383
94952,6815,33519,1249,2253,2023,1936,3.7,6.7,6.0,20.3,534,1035,1159,715,1218,864,3339
94954,7423,38201,1936,1898,1875,2498,5.1,5.0,4.9,19.4,1111,991,1080,825,907,795,3363
94956,27,1189,7,14,0,6,0.6,1.2,0.0,2.3,0,7,0,7,7,0,20
94957,598,2081,108,246,148,125,5.2,11.8,7.1,28.7,58,168,41,50,78,107,259
94960,3896,16028,773,1227,1131,1170,4.8,7.7,7.1,24.3,482,703,609,291,524,522,1737
94963,93,462,0,0,23,104,0.0,0.0,5.0,20.1,0,0,22,0,0,1,26
94964,0,2054,0,0,0,9,0.0,0.0,0.0,0.0,0,0,0,0,0,0,0
94965,1547,12044,506,457,338,427,4.2,3.8,2.8,12.8,328,155,245,178,302,93,660
94970,7,400,0,0,0,7,0.0,0.0,0.0,1.8,0,0,0,0,0,0,7
94971,47,364,0,25,0,22,0.0,6.9,0.0,12.9,0,11,0,0,14,0,36
94972,70,153,33,37,0,0,21.6,24.2,0.0,45.8,33,37,0,0,0,0,0
94973,101,1438,25,19,37,42,1.7,1.3,2.6,7.0,10,0,37,15,19,0,34
95002,416,1920,124,89,106,132,6.5,4.6,5.5,21.7,90,46,84,34,43,22,142
95003,4407,24977,977,1397,1235,1599,3.9,5.6,4.9,17.6,407,576,775,570,821,460,2236
95004,589,3902,157,276,69,117,4.0,7.1,1.8,15.1,37,93,41,120,183,28,403
95005,1678,7552,519,236,536,507,6.9,3.1,7.1,22.2,317,145,213,202,91,323,904
95006,1141,8802,184,393,474,506,2.1,4.5,5.4,13.0,104,259,310,80,134,164,453
95007,42,359,0,42,0,0,0.0,11.7,0.0,11.7,0,20,0,0,22,0,22
95008,10718,48746,2959,3169,2806,2667,6.1,6.5,5.8,22.0,1405,1625,1513,1554,1544,1293,5266
95010,1325,9243,282,439,341,463,3.1,4.7,3.7,14.3,172,302,175,110,137,166,495
95012,3921,10528,1123,1326,1080,538,10.7,12.6,10.3,37.2,669,702,460,454,624,620,1914
95013,0,53,0,0,0,0,0.0,0.0,0.0,0.0,0,0,0,0,0,0,0
95014,14762,61414,2867,3771,5426,4274,4.7,6.1,8.8,24.0,1623,1756,2902,1244,2015,2524,6902
95017,201,907,24,105,50,38,2.6,11.6,5.5,22.2,24,53,23,0,52,27,101
95018,778,6055,147,197,316,320,2.4,3.3,5.2,12.8,113,110,113,34,87,203,388
95019,1843,5891,470,589,680,211,8.0,10.0,11.5,31.3,301,339,244,169,250,436,855
95020,18589,68365,4166,5065,6056,5399,6.1,7.4,8.9,27.2,2185,2596,2913,1981,2469,3143,8996
95023,15165,57367,3636,4010,4810,4349,6.3,7.0,8.4,26.4,1800,1861,2591,1836,2149,2219,7496
95030,2409,13373,326,534,929,1002,2.4,4.0,6.9,18.0,111,301,493,215,233,436,1236
95032,6759,27678,1128,1829,2554,1770,4.1,6.6,9.2,24.4,494,1170,1331,634,659,1223,3145
95033,1886,9853,369,613,625,404,3.7,6.2,6.3,19.1,145,317,267,224,296,358,987
95035,16409,79393,4473,4581,4676,4156,5.6,5.8,5.9,20.7,2582,2548,2556,1891,2033,2120,7409
95037,13196,51867,3763,3071,4107,3408,7.3,5.9,7.9,25.4,1698,1425,1800,2065,1646,2307,7327
95039,434,1427,21,98,246,69,1.5,6.9,17.2,30.4,18,73,119,3,25,127,155
95041,169,803,88,40,31,17,11.0,5.0,3.9,21.0,53,9,0,35,31,31,97
95043,147,669,35,39,41,32,5.2,5.8,6.1,22.0,12,16,14,23,23,27,84
95045,678,4063,246,215,111,129,6.1,5.3,2.7,16.7,172,165,60,74,50,51,224
95046,820,5801,145,128,286,413,2.5,2.2,4.9,14.1,25,118,132,120,10,154,451
95050,6855,39905,2271,1744,1772,1931,5.7,4.4,4.4,17.2,1350,965,1053,921,779,719,3016
95051,11271,60499,3818,3478,2287,2790,6.3,5.7,3.8,18.6,2258,1810,1189,1560,1668,1098,5182
95053,50,3317,0,0,0,2191,0.0,0.0,0.0,1.5,0,0,0,0,0,0,30
95054,4856,24444,1593,1340,1261,1000,6.5,5.5,5.2,19.9,824,608,631,769,732,630,2499
95060,6449,46527,1726,1807,1690,2755,3.7,3.9,3.6,13.9,1062,1070,908,664,737,782,2726
95062,5568,36369,1488,1437,1554,1731,4.1,4.0,4.3,15.3,446,660,827,1042,777,727,3144
95064,343,9832,49,59,32,5616,0.5,0.6,0.3,3.5,22,31,25,27,28,7,168
95065,1570,8125,384,375,518,380,4.7,4.6,6.4,19.3,140,108,276,244,267,242,902
95066,2590,15233,670,739,701,1043,4.4,4.9,4.6,17.0,425,459,302,245,280,399,1122
95070,6285,31688,752,1664,2159,2329,2.4,5.3,6.8,19.8,427,922,1163,325,742,996,2988
95073,2462,11408,515,646,762,759,4.5,5.7,6.7,21.6,300,282,439,215,364,323,1090
95075,115,566,45,23,28,29,8.0,4.1,4.9,20.3,7,7,7,38,16,21,81
95076,22182,83716,5495,5671,6685,6669,6.6,6.8,8.0,26.5,2660,2982,3275,2835,2689,3410,11198
95110,4373,20314,1470,1131,1332,714,7.2,5.6,6.6,21.5,892,524,689,578,607,643,2045
95111,14902,59761,3043,3913,5548,4184,5.1,6.5,9.3,24.9,1594,2205,2860,1449,1708,2688,6979
95112,8349,58775,2682,1896,2270,5563,4.6,3.2,3.9,14.2,1180,1046,925,1502,850,1345,4330
95113,43,2161,0,12,21,10,0.0,0.6,1.0,2.0,0,0,0,0,12,21,43
95116,11719,50436,2923,3095,3468,3663,5.8,6.1,6.9,23.2,1641,1773,1796,1282,1322,1672,5203
95117,6671,28663,2278,1760,1750,1387,7.9,6.1,6.1,23.3,1275,807,734,1003,953,1016,3374
95118,8002,32827,2492,2027,2329,2037,7.6,6.2,7.1,24.4,1364,958,1190,1128,1069,1139,3948
95119,2364,10461,652,622,699,610,6.2,5.9,6.7,22.6,362,249,507,290,373,192,1065
95120,8766,38003,1232,2426,2901,3633,3.2,6.4,7.6,23.1,637,1129,1523,595,1297,1378,4337
95121,6966,36657,1401,1910,2335,2091,3.8,5.2,6.4,19.0,877,1037,1344,524,873,991,2993
95122,12664,52555,2468,3541,4291,3973,4.7,6.7,8.2,24.1,1068,1870,2066,1400,1671,2225,6518
95123,15271,70952,4432,4209,3976,4413,6.2,5.9,5.6,21.5,2067,2074,2253,2365,2135,1723,7498
95124,13157,51803,3078,3675,4174,3304,5.9,7.1,8.1,25.4,1585,1901,1880,1493,1774,2294,6496
95125,11112,53333,3366,2979,2883,2723,6.3,5.6,5.4,20.8,1580,1550,1322,1786,1429,1561,5899
95126,6346,36996,1706,1560,1977,1798,4.6,4.2,5.3,17.2,744,983,992,962,577,985,2989
95127,13750,62269,3199,3755,4571,3740,5.1,6.0,7.3,22.1,1824,1953,2229,1375,1802,2342,6591
95128,5961,33653,1517,1686,1565,1745,4.5,5.0,4.7,17.7,798,954,957,719,732,608,2676
95129,8828,39797,1771,2423,2867,2243,4.5,6.1,7.2,22.2,794,1409,1459,977,1014,1408,4362
95130,3282,13376,749,1178,848,674,5.6,8.8,6.3,24.5,328,598,320,421,580,528,1707
95131,6037,31335,1803,1516,1750,1822,5.8,4.8,5.6,19.3,964,657,978,839,859,772,2879
95132,7111,40981,1835,1725,1866,2454,4.5,4.2,4.6,17.4,1219,838,914,616,887,952,3301
95133,5604,28749,1531,1755,1459,1590,5.3,6.1,5.1,19.5,675,905,795,856,850,664,2872
95134,4384,30916,2409,946,550,684,7.8,3.1,1.8,14.2,958,522,166,1451,424,384,2421
95135,4431,21402,648,1230,1571,1383,3.0,5.7,7.3,20.7,219,640,976,429,590,595,1996
95136,10186,47294,2583,2603,3148,2704,5.5,5.5,6.7,21.5,1294,1422,1579,1289,1181,1569,4913
95138,4819,19420,936,1343,1525,1723,4.8,6.9,7.9,24.8,589,893,781,347,450,744,2148
95139,1989,7232,528,630,537,470,7.3,8.7,7.4,27.5,427,236,250,101,394,287,950
95140,0,91,0,0,0,0,0.0,0.0,0.0,0.0,0,0,0,0,0,0,0
95148,9346,45688,2080,2369,2711,3405,4.6,5.2,5.9,20.5,1034,1103,1406,1046,1266,1305,4736
95202,1447,6000,445,315,495,268,7.4,5.3,8.3,24.1,257,68,350,188,247,145,580
95203,4282,16237,1376,1500,802,887,8.5,9.2,4.9,26.4,754,801,251,622,699,551,2134
95204,7005,30406,1732,1812,2449,1845,5.7,6.0,8.1,23.0,768,974,1224,964,838,1225,3444
95205,12472,40128,3396,3728,3701,3027,8.5,9.3,9.2,31.1,1839,1844,1387,1557,1884,2314,6624
95206,20409,68031,4866,5223,6316,6524,7.2,7.7,9.3,30.0,2188,2753,3011,2678,2470,3305,10501
95207,13496,52877,3623,3487,4133,3937,6.9,6.6,7.8,25.5,1548,1612,1932,2075,1875,2201,7117
95209,12433,46756,3114,3439,3693,3497,6.7,7.4,7.9,26.6,1353,1831,1848,1761,1608,1845,6164
95210,12704,42654,3615,3526,3307,3636,8.5,8.3,7.8,29.8,1510,1867,1820,2105,1659,1487,6214
95211,35,1676,0,0,0,954,0.0,0.0,0.0,2.1,0,0,0,0,0,0,20
95212,6669,27848,1239,1091,2506,2702,4.4,3.9,9.0,23.9,774,573,968,465,518,1538,3388
95215,6514,25647,1575,1899,1817,2090,6.1,7.4,7.1,25.4,871,1082,806,704,817,1011,3168
95219,8124,30165,1790,2153,2253,2695,5.9,7.1,7.5,26.9,1200,1030,1273,590,1123,980,3810
95220,2207,8244,447,484,578,919,5.4,5.9,7.0,26.8,251,205,366,196,279,212,1050
95221,43,398,0,0,21,73,0.0,0.0,5.3,10.8,0,0,0,0,0,21,43
95222,928,5236,118,259,243,464,2.3,4.9,4.6,17.7,53,210,102,65,49,141,356
95223,222,2470,43,73,97,9,1.7,3.0,3.9,9.0,32,23,9,11,50,88,158
95224,76,311,23,53,0,0,7.4,17.0,0.0,24.4,7,32,0,16,21,0,37
95225,131,1019,0,23,90,35,0.0,2.3,8.8,12.9,0,0,41,0,23,49,90
95226,0,0,0,0,0,0,,,,,0,0,0,0,0,0,0
95227,242,1180,43,79,110,23,3.6,6.7,9.3,20.5,13,29,110,30,50,0,80
95228,871,4648,274,224,226,198,5.9,4.8,4.9,18.7,194,90,142,80,134,84,445
95230,128,513,0,58,42,42,0.0,11.3,8.2,25.0,0,45,0,0,13,42,66
95231,840,4865,198,288,213,286,4.1,5.9,4.4,17.3,126,139,88,72,149,125,429
95232,0,202,0,0,0,0,0.0,0.0,0.0,0.0,0,0,0,0,0,0,0
95233,0,233,0,0,0,13,0.0,0.0,0.0,0.0,0,0,0,0,0,0,0
95236,1198,4518,317,164,349,394,7.0,3.6,7.7,26.5,97,107,114,220,57,235,658
95237,963,3992,275,251,263,215,6.9,6.3,6.6,24.1,225,86,174,50,165,89,362
95240,13417,50245,3605,3701,4000,3377,7.2,7.4,8.0,26.7,1709,2196,2263,1896,1505,1737,6151
95242,6269,27433,1126,1465,2374,1850,4.1,5.3,8.7,22.9,607,764,1301,519,701,1073,2850
95245,416,2813,189,69,43,116,6.7,2.5,1.5,14.8,161,9,43,28,60,0,126
95246,44,1548,44,0,0,0,2.8,0.0,0.0,2.8,0,0,0,44,0,0,44
95247,657,4022,196,265,150,77,4.9,6.6,3.7,16.3,111,135,143,85,130,7,268
95248,62,106,0,19,16,27,0.0,17.9,15.1,58.5,0,0,16,0,19,0,19
95249,913,4908,180,269,201,390,3.7,5.5,4.1,18.6,90,18,100,90,251,101,530
95251,0,521,0,0,0,0,0.0,0.0,0.0,0.0,0,0,0,0,0,0,0
95252,3001,14622,716,1026,755,774,4.9,7.0,5.2,20.5,320,689,195,396,337,560,1557
95253,229,504,29,74,126,0,5.8,14.7,25.0,45.4,17,74,27,12,0,99,111
95254,0,350,0,0,0,28,0.0,0.0,0.0,0.0,0,0,0,0,0,0,0
95255,321,1787,83,78,74,100,4.6,4.4,4.1,18.0,49,78,0,34,0,74,142
95257,0,398,0,0,0,0,0.0,0.0,0.0,0.0,0,0,0,0,0,0,0
95258,703,3885,119,279,233,155,3.1,7.2,6.0,18.1,9,122,98,110,157,135,452
95301,11626,41660,2431,3490,3761,2968,5.8,8.4,9.0,27.9,1362,2261,1910,1069,1229,1851,5071
95303,177,891,41,34,75,56,4.6,3.8,8.4,19.9,38,11,39,3,23,36,85
95304,3362,15235,444,1042,1087,1164,2.9,6.8,7.1,22.1,303,678,468,141,364,619,1657
95305,0,158,0,0,0,0,0.0,0.0,0.0,0.0,0,0,0,0,0,0,0
95306,114,784,72,13,13,21,9.2,1.7,1.7,14.5,0,6,8,72,7,5,96
95307,13940,47978,3630,3622,4670,3318,7.6,7.5,9.7,29.1,1786,2062,2622,1844,1560,2048,6390
95309,0,0,0,0,0,0,,,,,0,0,0,0,0,0,0
95310,428,1849,53,140,91,144,2.9,7.6,4.9,23.1,36,84,62,17,56,29,246
95311,373,2182,0,183,82,110,0.0,8.4,3.8,17.1,0,166,68,0,17,14,119
95312,94,284,53,20,10,11,18.7,7.0,3.5,33.1,4,20,10,49,0,0,49
95313,126,860,77,16,24,26,9.0,1.9,2.8,14.7,38,6,12,39,10,12,70
95315,3913,13317,880,983,1117,1417,6.6,7.4,8.4,29.4,440,559,653,440,424,464,1688
95316,1614,7154,416,320,569,536,5.8,4.5,8.0,22.6,157,118,101,259,202,468,1160
95317,319,948,86,95,87,112,9.1,10.0,9.2,33.6,42,33,56,44,62,31,174
95318,121,522,11,77,33,0,2.1,14.8,6.3,23.2,11,0,33,0,77,0,77
95319,265,1651,96,68,57,134,5.8,4.1,3.5,16.1,19,40,41,77,28,16,143
95320,3184,12385,1124,619,968,660,9.1,5.0,7.8,25.7,505,308,582,619,311,386,1662
95321,417,4068,128,186,84,139,3.1,4.6,2.1,10.3,73,82,19,55,104,65,243
95322,2496,9392,452,666,743,803,4.8,7.1,7.9,26.6,272,444,263,180,222,480,1019
95323,388,1516,105,78,116,128,6.9,5.1,7.7,25.6,58,50,39,47,28,77,202
95324,2439,8763,652,494,980,654,7.4,5.6,11.2,27.8,384,318,619,268,176,361,896
95325,0,44,0,0,0,0,0.0,0.0,0.0,0.0,0,0,0,0,0,0,0
95326,2668,10672,508,816,846,800,4.8,7.6,7.9,25.0,215,547,366,293,269,480,1311
95327,1240,8788,377,156,494,312,4.3,1.8,5.6,14.1,192,71,100,185,85,394,676
95328,1405,3856,119,554,419,426,3.1,14.4,10.9,36.4,82,240,267,37,314,152,652
95329,331,2394,78,105,128,42,3.3,4.4,5.3,13.8,36,48,45,42,57,83,202
95330,8853,30051,2287,2496,2664,2099,7.6,8.3,8.9,29.5,1258,1126,1379,1029,1370,1285,4265
95333,1096,3157,469,315,190,195,14.9,10.0,6.0,34.7,318,124,108,151,191,82,484
95334,5102,17302,1366,1375,1525,1248,7.9,7.9,8.8,29.5,601,570,907,765,805,618,2755
95335,0,58,0,0,0,0,0.0,0.0,0.0,0.0,0,0,0,0,0,0,0
95336,11365,49145,2827,3259,3160,3241,5.8,6.6,6.4,23.1,1386,1570,1681,1441,1689,1479,5864
95337,12260,44192,3373,4159,3162,2289,7.6,9.4,7.2,27.7,2356,2126,1698,1017,2033,1464,5227
95338,2068,10102,500,719,565,333,4.9,7.1,5.6,20.5,229,404,261,271,315,304,1068
95340,8606,36833,2338,2490,2272,3853,6.3,6.8,6.2,23.4,1355,1117,1103,983,1373,1169,4393
95341,12264,34541,2918,3212,3677,3504,8.4,9.3,10.6,35.5,1646,1651,1847,1272,1561,1830,6132
95345,86,528,0,45,0,41,0.0,8.5,0.0,16.3,0,0,0,0,45,0,45
95346,180,1041,107,0,0,73,10.3,0.0,0.0,17.3,22,0,0,85,0,0,85
95348,9162,35853,2355,2822,2652,2806,6.6,7.9,7.4,25.6,1003,1588,1382,1352,1234,1270,4292
95350,14150,55368,4403,3822,3718,3838,8.0,6.9,6.7,25.6,1801,1892,2159,2602,1930,1559,6984
95351,14530,48134,3751,3935,4625,3688,7.8,8.2,9.6,30.2,1911,1752,2395,1840,2183,2230,7582
95354,6677,25100,1752,2013,2032,1421,7.0,8.0,8.1,26.6,961,1029,998,791,984,1034,3253
95355,14336,60338,3292,3791,4215,4520,5.5,6.3,7.0,23.8,1719,2149,2174,1573,1642,2041,6725
95356,7940,33033,1535,1915,2715,2476,4.6,5.8,8.2,24.0,658,838,1234,877,1077,1481,4298
95357,4212,14403,900,1457,1355,670,6.2,10.1,9.4,29.2,562,943,658,338,514,697,1711
95358,9795,31268,2774,2421,3095,2278,8.9,7.7,9.9,31.3,1604,1258,1828,1170,1163,1267,4314
95360,3465,13781,932,905,1027,1394,6.8,6.6,7.5,25.1,340,111,520,592,794,507,2271
95361,8779,35107,1956,2630,2401,2637,5.6,7.5,6.8,25.0,939,1313,1383,1017,1317,1018,4172
95363,8890,29784,2390,1952,2760,2831,8.0,6.6,9.3,29.8,1298,1006,1177,1092,946,1583,4304
95364,0,0,0,0,0,0,,,,,0,0,0,0,0,0,0
95365,1144,3882,291,286,331,317,7.5,7.4,8.5,29.5,161,198,198,130,88,133,499
95366,4680,18500,1249,1293,1372,1065,6.8,7.0,7.4,25.3,749,748,783,500,545,589,1999
95367,7525,25162,1955,1641,2657,1932,7.8,6.5,10.6,29.9,1058,960,1187,897,681,1470,3624
95368,3081,14849,952,836,971,987,6.4,5.6,6.5,20.7,638,381,404,314,455,567,1627
95369,145,778,30,32,48,67,3.9,4.1,6.2,18.6,30,7,27,0,25,21,53
95370,5179,28548,983,1781,1409,1496,3.4,6.2,4.9,18.1,422,947,753,561,834,656,2668
95372,405,1639,144,210,51,45,8.8,12.8,3.1,24.7,63,132,32,81,78,19,178
95374,421,1581,112,120,138,88,7.1,7.6,8.7,26.6,95,30,69,17,90,69,220
95375,0,64,0,0,0,0,0.0,0.0,0.0,0.0,0,0,0,0,0,0,0
95376,14639,55038,4433,3673,4404,3752,8.1,6.7,8.0,26.6,2363,2024,2297,2070,1649,2107,6866
95377,9314,35001,1741,2095,3997,2876,5.0,6.0,11.4,26.6,844,1226,2525,897,869,1472,3985
95379,799,3828,255,201,151,222,6.7,5.3,3.9,20.9,179,147,98,76,54,53,284
95380,12005,44204,3175,2944,3634,3333,7.2,6.7,8.2,27.2,1497,1539,1657,1678,1405,1977,6232
95382,9660,38727,2431,2724,2695,2959,6.3,7.0,7.0,24.9,1587,1164,1581,844,1560,1114,4440
95383,461,3415,278,123,60,10,8.1,3.6,1.8,13.5,233,64,54,45,59,6,110
95385,137,531,43,55,35,4,8.1,10.4,6.6,25.8,34,5,35,9,50,0,59
95386,2864,10387,595,665,985,1091,5.7,6.4,9.5,27.6,250,421,502,345,244,483,1258
95387,483,1215,155,178,89,124,12.8,14.7,7.3,39.8,155,59,89,0,119,0,136
95388,4262,13518,1200,1201,1191,1130,8.9,8.9,8.8,31.5,693,725,564,507,476,627,1938
95389,52,1963,0,29,0,111,0.0,1.5,0.0,2.6,0,0,0,0,29,0,52
95391,7362,23696,1415,2018,2470,2169,6.0,8.5,10.4,31.1,660,1061,1196,755,957,1274,3540
95401,7006,36905,1649,1922,2387,1902,4.5,5.2,6.5,19.0,509,1143,880,1140,779,1507,3823
95403,9968,44677,2613,2858,3025,2785,5.8,6.4,6.8,22.3,1382,1559,1590,1231,1299,1435,4761
95404,7256,37437,1908,1854,2389,2009,5.1,5.0,6.4,19.4,1100,1089,1128,808,765,1261,3346
95405,4297,23748,1029,1314,1216,1284,4.3,5.5,5.1,18.1,499,805,586,530,509,630,2030
95407,10890,42138,2068,2482,3773,3685,4.9,5.9,9.0,25.8,1045,1330,1849,1023,1152,1924,5403
95409,4192,26158,867,1124,1348,1427,3.3,4.3,5.2,16.0,556,660,704,311,464,644,1720
95410,34,797,0,0,34,100,0.0,0.0,4.3,4.3,0,0,0,0,0,34,34
95412,69,271,0,34,19,16,0.0,12.5,7.0,25.5,0,13,0,0,21,19,56
95415,413,1383,44,149,143,86,3.2,10.8,10.3,29.9,0,56,70,44,93,73,242
95417,82,211,36,46,0,9,17.1,21.8,0.0,38.9,0,0,0,36,46,0,82
95419,0,169,0,0,0,14,0.0,0.0,0.0,0.0,0,0,0,0,0,0,0
95420,100,351,99,1,0,0,28.2,0.3,0.0,28.5,0,1,0,99,0,0,99
95421,223,1679,101,35,52,38,6.0,2.1,3.1,13.3,36,10,26,65,25,26,128
95422,4438,16998,872,1360,1342,1182,5.1,8.0,7.9,26.1,216,791,645,656,569,697,2235
95423,507,3322,123,148,113,204,3.7,4.5,3.4,15.3,79,112,6,44,36,107,293
95425,2190,11331,314,860,620,710,2.8,7.6,5.5,19.3,58,363,344,256,497,276,1227
95426,211,1178,35,90,48,61,3.0,7.6,4.1,17.9,0,0,25,35,90,23,164
95427,55,589,32,0,0,48,5.4,0.0,0.0,9.3,0,0,0,32,0,0,32
95428,683,2775,267,181,117,209,9.6,6.5,4.2,24.6,99,136,77,168,45,40,281
95429,0,118,0,0,0,0,0.0,0.0,0.0,0.0,0,0,0,0,0,0,0
95430,0,0,0,0,0,0,,,,,0,0,0,0,0,0,0
95431,4,76,0,0,0,4,0.0,0.0,0.0,5.3,0,0,0,0,0,0,2
95432,17,614,0,5,12,0,0.0,0.8,2.0,2.8,0,5,12,0,0,0,0
95435,144,347,0,72,72,53,0.0,20.7,20.7,41.5,0,72,72,0,0,0,0
95436,1275,6008,370,387,250,363,6.2,6.4,4.2,21.2,267,339,89,103,48,161,396
95437,2887,14865,802,759,741,821,5.4,5.1,5.0,19.4,361,326,347,441,433,394,1410
95439,173,782,30,53,90,0,3.8,6.8,11.5,22.1,30,32,55,0,21,35,56
95441,243,1819,76,66,77,76,4.2,3.6,4.2,13.4,63,28,33,13,38,44,107
95442,237,2592,36,56,120,37,1.4,2.2,4.6,9.1,20,56,103,16,0,17,38
95443,113,190,15,98,0,0,7.9,51.6,0.0,59.5,15,62,0,0,36,0,36
95444,46,516,9,19,12,23,1.7,3.7,2.3,8.9,0,0,12,9,19,0,34
95445,339,2012,23,82,119,135,1.1,4.1,5.9,16.8,0,45,41,23,37,78,173
95446,368,4709,48,86,190,184,1.0,1.8,4.0,7.8,48,25,78,0,61,112,185
95448,2475,16745,828,550,681,926,4.9,3.3,4.1,14.8,373,180,340,455,370,341,1412
95449,326,1785,126,68,113,31,7.1,3.8,6.3,18.3,87,33,51,39,35,62,155
95450,42,272,0,19,15,11,0.0,7.0,5.5,15.4,0,10,7,0,9,8,17
95451,2583,12957,796,689,682,618,6.1,5.3,5.3,19.9,390,201,348,406,488,334,1341
95452,134,1240,62,39,25,8,5.0,3.1,2.0,10.8,30,0,12,32,39,13,84
95453,2186,11254,802,448,476,750,7.1,4.0,4.2,19.4,388,329,341,414,119,135,958
95454,218,1714,43,127,9,51,2.5,7.4,0.5,12.7,8,79,7,35,48,2,85
95456,167,775,0,21,52,94,0.0,2.7,6.7,21.5,0,13,30,0,8,22,84
95457,615,3252,167,190,125,186,5.1,5.8,3.8,18.9,135,81,0,32,109,125,399
95458,520,3303,113,231,160,60,3.4,7.0,4.8,15.7,79,63,88,34,168,72,274
95459,188,853,37,17,39,113,4.3,2.0,4.6,22.0,32,15,19,5,2,20,62
95460,249,2349,0,86,78,138,0.0,3.7,3.3,10.6,0,86,47,0,0,31,98
95461,767,3909,223,92,295,194,5.7,2.4,7.5,19.6,86,18,181,137,74,114,390
95462,99,1091,2,16,52,66,0.2,1.5,4.8,9.1,0,6,16,2,10,36,65
95463,4,88,0,0,0,14,0.0,0.0,0.0,4.5,0,0,0,0,0,0,0
95464,594,2466,261,159,130,74,10.6,6.4,5.3,24.1,237,19,53,24,140,77,259
95465,173,1251,31,59,83,25,2.5,4.7,6.6,13.8,0,59,4,31,0,79,110
95466,115,880,26,13,24,53,3.0,1.5,2.7,13.1,16,13,24,10,0,0,10
95467,1357,5795,217,520,473,240,3.7,9.0,8.2,23.4,99,302,337,118,218,136,488
95468,362,1822,68,128,81,116,3.7,7.0,4.4,19.9,24,61,29,44,67,52,208
95469,223,1323,30,86,59,48,2.3,6.5,4.5,16.9,23,27,14,7,59,45,153
95470,1376,6068,254,560,203,375,4.2,9.2,3.3,22.7,117,419,147,137,141,56,586
95471,163,780,26,7,50,80,3.3,0.9,6.4,20.9,0,7,0,26,0,50,126
95472,4545,28443,969,1388,1177,1525,3.4,4.9,4.1,16.0,504,607,550,465,781,627,2287
95476,5861,36386,1780,1404,1599,1649,4.9,3.9,4.4,16.1,914,615,811,866,789,788,3068
95480,3,6,2,1,0,0,33.3,16.7,0.0,50.0,0,1,0,2,0,0,2
95482,8413,34183,2004,2501,2735,2083,5.9,7.3,8.0,24.6,1016,1146,1383,988,1355,1352,4458
95485,476,2909,209,105,119,49,7.2,3.6,4.1,16.4,123,40,58,86,65,61,252
95486,0,27,0,0,0,0,0.0,0.0,0.0,0.0,0,0,0,0,0,0,0
95488,21,366,0,21,0,0,0.0,5.7,0.0,5.7,0,6,0,0,15,0,15
95490,2865,14360,1026,1002,640,591,7.1,7.0,4.5,20.0,595,491,364,431,511,276,1294
95492,6477,28096,1289,1896,1776,2175,4.6,6.7,6.3,23.1,744,907,1155,545,989,621,2909
95493,0,144,0,0,0,0,0.0,0.0,0.0,0.0,0,0,0,0,0,0,0
95494,0,151,0,0,0,0,0.0,0.0,0.0,0.0,0,0,0,0,0,0,0
95497,72,1224,16,14,42,0,1.3,1.1,3.4,5.9,16,0,13,0,14,29,43
95501,4519,23706,1097,1303,1358,1295,4.6,5.5,5.7,19.1,422,951,726,675,352,632,1960
95503,4418,24072,1209,1105,1201,1313,5.0,4.6,5.0,18.4,605,531,664,604,574,537,2166
95511,0,102,0,0,0,0,0.0,0.0,0.0,0.0,0,0,0,0,0,0,0
95514,33,117,0,0,17,16,0.0,0.0,14.5,28.2,0,0,0,0,0,17,17
95519,4125,18781,1219,1389,961,1022,6.5,7.4,5.1,22.0,781,684,500,438,705,461,1844
95521,2924,21712,652,678,1029,2281,3.0,3.1,4.7,13.5,274,282,346,378,396,683,1743
95524,335,1700,46,183,69,84,2.7,10.8,4.1,19.7,22,161,21,24,22,48,122
95525,148,1358,72,38,35,4,5.3,2.8,2.6,10.9,29,19,20,43,19,15,80
95526,133,638,39,17,38,60,6.1,2.7,6.0,20.8,0,5,24,39,12,14,94
95527,246,701,47,32,95,88,6.7,4.6,13.6,35.1,0,12,54,47,20,41,144
95528,323,1555,116,86,70,72,7.5,5.5,4.5,20.8,54,40,33,62,46,37,165
95531,5012,23029,1404,1449,1438,1199,6.1,6.3,6.2,21.8,603,916,610,801,533,828,2400
95536,594,3258,85,88,264,198,2.6,2.7,8.1,18.2,40,47,166,45,41,98,245
95537,0,629,0,0,0,0,0.0,0.0,0.0,0.0,0,0,0,0,0,0,0
95538,119,1022,0,50,24,58,0.0,4.9,2.3,11.6,0,19,0,0,31,24,55
95540,3050,14415,791,1025,687,902,5.5,7.1,4.8,21.2,327,474,384,464,551,303,1634
95542,454,2862,152,97,141,208,5.3,3.4,4.9,15.9,105,0,80,47,97,61,205
95543,25,376,11,12,0,8,2.9,3.2,0.0,6.6,11,12,0,0,0,0,0
95545,54,492,19,20,8,26,3.9,4.1,1.6,11.0,14,17,8,5,3,0,12
95546,706,2666,175,228,197,160,6.6,8.6,7.4,26.5,73,107,92,102,121,105,378
95547,162,1121,25,17,97,59,2.2,1.5,8.7,14.5,13,7,45,12,10,52,86
95548,232,1034,37,84,71,49,3.6,8.1,6.9,22.4,19,79,25,18,5,46,98
95549,270,1140,108,79,68,69,9.5,6.9,6.0,23.7,37,30,43,71,49,25,156
95550,22,213,22,0,0,0,10.3,0.0,0.0,10.3,22,0,0,0,0,0,0
95551,255,1789,18,46,89,331,1.0,2.6,5.0,14.3,9,14,40,9,32,49,156
95552,8,423,0,8,0,0,0.0,1.9,0.0,1.9,0,0,0,0,8,0,8
95553,265,1037,32,65,168,32,3.1,6.3,16.2,25.6,32,28,63,0,37,105,142
95554,41,313,41,0,0,0,13.1,0.0,0.0,13.1,41,0,0,0,0,0,0
95555,60,370,25,7,19,9,6.8,1.9,5.1,16.2,16,3,10,9,4,9,31
95556,283,692,143,111,21,8,20.7,16.0,3.0,40.9,26,5,2,117,106,19,248
95558,27,246,0,0,25,7,0.0,0.0,10.2,11.0,0,0,10,0,0,15,17
95559,0,0,0,0,0,0,,,,,0,0,0,0,0,0,0
95560,253,1337,0,253,0,0,0.0,18.9,0.0,18.9,0,47,0,0,206,0,206
95562,974,3396,273,320,381,82,8.0,9.4,11.2,28.7,238,160,270,35,160,111,306
95563,84,911,66,0,18,58,7.2,0.0,2.0,9.2,66,0,18,0,0,0,0
95564,96,564,23,29,17,31,4.1,5.1,3.0,17.0,3,16,9,20,13,8,52
95565,195,860,56,55,44,63,6.5,6.4,5.1,22.7,25,15,7,31,40,37,148
95567,410,2001,55,79,185,160,2.7,3.9,9.2,20.5,28,0,116,27,79,69,203
95568,19,224,0,3,4,41,0.0,1.3,1.8,8.5,0,0,1,0,3,3,15
95569,0,91,0,0,0,0,0.0,0.0,0.0,0.0,0,0,0,0,0,0,0
95570,478,2523,70,112,46,302,2.8,4.4,1.8,18.9,29,30,31,41,82,15,282
95571,0,30,0,0,0,0,0.0,0.0,0.0,0.0,0,0,0,0,0,0,0
95573,257,1417,43,85,58,71,3.0,6.0,4.1,18.1,0,85,29,43,0,29,72
95585,59,545,27,5,9,34,5.0,0.9,1.7,10.8,5,0,0,22,5,9,36
95587,0,0,0,0,0,0,,,,,0,0,0,0,0,0,0
95589,210,1153,42,84,79,5,3.6,7.3,6.9,18.2,0,84,47,42,0,32,74
95595,24,143,0,11,13,0,0.0,7.7,9.1,16.8,0,11,6,0,0,7,7
95601,29,352,4,16,9,0,1.1,4.5,2.6,8.2,0,14,0,4,2,9,15
95602,2669,18610,459,688,1052,995,2.5,3.7,5.7,14.3,191,359,556,268,329,496,1233
95603,4935,28366,1101,1611,1369,1393,3.9,5.7,4.8,17.4,577,814,524,524,797,845,2637
95604,0,34,0,0,0,0,0.0,0.0,0.0,0.0,0,0,0,0,0,0,0
95605,3461,14291,822,649,1314,1317,5.8,4.5,9.2,24.2,376,296,670,446,353,644,1694
95606,10,185,2,6,2,0,1.1,3.2,1.1,5.4,2,3,2,0,3,0,3
95607,0,235,0,0,0,0,0.0,0.0,0.0,0.0,0,0,0,0,0,0,0
95608,12148,63715,3255,2999,3670,3396,5.1,4.7,5.8,19.1,1895,1338,1729,1360,1661,1941,6090
95610,9428,46219,2546,2297,3048,2721,5.5,5.0,6.6,20.4,1187,1099,1458,1359,1198,1590,4805
95612,306,1462,122,108,46,144,8.3,7.4,3.1,20.9,23,38,35,99,70,11,205
95613,0,0,0,0,0,0,,,,,0,0,0,0,0,0,0
95614,857,4479,94,295,220,331,2.1,6.6,4.9,19.1,42,127,85,52,168,135,463
95615,214,1147,78,74,39,53,6.8,6.5,3.4,18.7,78,8,10,0,66,29,95
95616,5409,52090,1045,1566,1650,8823,2.0,3.0,3.2,10.4,393,909,893,652,657,757,2677
95618,5101,26946,1433,1223,1348,2289,5.3,4.5,5.0,18.9,704,694,470,729,529,878,2559
95619,1581,6414,554,285,644,294,8.6,4.4,10.0,24.6,372,123,343,182,162,301,665
95620,5713,22004,1467,1640,1744,1551,6.7,7.5,7.9,26.0,828,704,1036,639,936,708,2694
95621,8446,42089,2107,2185,2684,2159,5.0,5.2,6.4,20.1,982,1206,1565,1125,979,1119,4147
95623,709,4488,90,96,211,347,2.0,2.1,4.7,15.8,16,62,147,74,34,64,241
95624,17597,67915,3824,4040,5613,5943,5.6,5.9,8.3,25.9,2058,2190,2807,1766,1850,2806,8238
95625,0,88,0,0,0,0,0.0,0.0,0.0,0.0,0,0,0,0,0,0,0
95626,1117,5845,218,324,371,270,3.7,5.5,6.3,19.1,85,191,201,133,133,170,544
95627,1429,4137,552,378,361,235,13.3,9.1,8.7,34.5,210,227,187,342,151,174,697
95628,8601,44256,2284,2325,2480,2442,5.2,5.3,5.6,19.4,999,1240,1293,1285,1085,1187,4239
95629,61,747,33,28,0,17,4.4,3.7,0.0,8.2,33,0,0,0,28,0,28
95630,18900,76599,4489,5005,6043,5072,5.9,6.5,7.9,24.7,2110,2459,3149,2379,2546,2894,9751
95631,1392,6244,87,327,641,435,1.4,5.2,10.3,22.3,47,231,402,40,96,239,490
95632,7230,31217,1561,2182,2212,1915,5.0,7.0,7.1,23.2,946,948,1140,615,1234,1072,3399
95633,791,3305,268,150,316,57,8.1,4.5,9.6,23.9,59,122,99,209,28,217,511
95634,509,3878,138,89,196,172,3.6,2.3,5.1,13.1,76,53,147,62,36,49,197
95635,71,948,3,63,5,0,0.3,6.6,0.5,7.5,3,26,5,0,37,0,37
95636,392,1374,0,145,189,58,0.0,10.6,13.8,28.5,0,20,135,0,125,54,179
95637,25,276,13,12,0,0,4.7,4.3,0.0,9.1,0,12,0,13,0,0,13
95638,325,2246,71,72,87,125,3.2,3.2,3.9,14.5,19,36,51,52,36,36,178
95639,46,314,46,0,0,40,14.6,0.0,0.0,14.6,20,0,0,26,0,0,26
95640,2058,12518,653,378,633,555,5.2,3.0,5.1,16.4,285,95,296,368,283,337,1163
95641,219,1517,63,30,91,42,4.2,2.0,6.0,14.4,19,8,65,44,22,26,96
95642,1062,7152,257,233,398,240,3.6,3.3,5.6,14.8,163,165,251,94,68,147,427
95645,283,1162,52,112,93,52,4.5,9.6,8.0,24.4,29,23,23,23,89,70,208
95646,85,249,58,27,0,0,23.3,10.8,0.0,34.1,29,27,0,29,0,0,29
95648,12647,55350,2874,3903,3716,3236,5.2,7.1,6.7,22.8,1581,1967,1788,1293,1936,1928,6137
95650,2665,14098,579,840,698,895,4.1,6.0,5.0,18.9,399,651,415,180,189,283,903
95651,166,738,0,108,30,80,0.0,14.6,4.1,22.5,0,15,30,0,93,0,121
95652,431,1193,71,150,149,192,6.0,12.6,12.5,36.1,50,72,54,21,78,95,194
95653,1,455,0,0,0,26,0.0,0.0,0.0,0.2,0,0,0,0,0,0,0
95655,1540,4954,411,413,447,310,8.3,8.3,9.0,31.1,75,216,179,336,197,268,904
95658,1070,5974,277,264,352,278,4.6,4.4,5.9,17.9,96,165,171,181,99,181,564
95659,201,790,39,66,62,77,4.9,8.4,7.8,25.4,16,21,15,23,45,47,138
95660,9888,35458,2943,2578,3009,2392,8.3,7.3,8.5,27.9,1766,1391,1475,1177,1187,1534,4491
95661,6632,32827,1648,1712,2192,1662,5.0,5.2,6.7,20.2,854,781,1014,794,931,1178,3574
95662,6883,32436,1837,1733,2036,1926,5.7,5.3,6.3,21.2,1062,750,957,775,983,1079,3376
95663,430,2659,77,108,206,63,2.9,4.1,7.7,16.2,21,62,62,56,46,144,258
95664,166,1133,36,72,42,50,3.2,6.4,3.7,14.7,0,55,0,36,17,42,111
95665,828,4693,284,286,111,173,6.1,6.1,2.4,17.6,174,133,41,110,153,70,396
95666,686,5885,114,198,161,357,1.9,3.4,2.7,11.7,57,167,77,57,31,84,240
95667,6425,36084,1277,1989,2003,1795,3.5,5.5,5.6,17.8,657,1004,849,620,985,1154,3324
95668,80,507,1,27,33,33,0.2,5.3,6.5,15.8,1,5,15,0,22,18,45
95669,367,2514,37,137,115,223,1.5,5.4,4.6,14.6,8,80,54,29,57,61,185
95670,14066,59449,4014,3848,4123,3218,6.8,6.5,6.9,23.7,1747,1844,2208,2267,2004,1915,7334
95671,0,4478,0,0,0,0,0.0,0.0,0.0,0.0,0,0,0,0,0,0,0
95672,1034,5744,268,272,275,313,4.7,4.7,4.8,18.0,124,141,236,144,131,39,463
95673,3938,16665,1242,1055,1130,1037,7.5,6.3,6.8,23.6,544,502,418,698,553,712,2212
95674,256,859,32,78,98,54,3.7,9.1,11.4,29.8,5,49,71,27,29,27,126
95675,108,487,0,0,108,0,0.0,0.0,22.2,22.2,0,0,80,0,0,28,28
95676,32,113,6,8,8,19,5.3,7.1,7.1,28.3,6,0,0,0,8,8,26
95677,6753,28591,1802,1981,1846,1907,6.3,6.9,6.5,23.6,846,1087,897,956,894,949,3320
95678,9489,45210,2479,2106,3018,3092,5.5,4.7,6.7,21.0,1259,1183,1540,1220,923,1478,4626
95679,27,131,0,27,0,0,0.0,20.6,0.0,20.6,0,27,0,0,0,0,0
95680,0,9,0,0,0,0,0.0,0.0,0.0,0.0,0,0,0,0,0,0,0
95681,452,1370,77,156,219,0,5.6,11.4,16.0,33.0,0,92,219,77,64,0,141
95682,5926,29750,1281,1499,2041,1645,4.3,5.0,6.9,19.9,725,745,1246,556,754,795,2549
95683,1191,6330,225,81,574,358,3.6,1.3,9.1,18.8,157,35,218,68,46,356,702
95684,190,2913,21,89,58,22,0.7,3.1,2.0,6.5,21,67,8,0,22,50,87
95685,764,4703,122,210,287,243,2.6,4.5,6.1,16.2,70,78,101,52,132,186,423
95686,319,1194,70,109,76,74,5.9,9.1,6.4,26.7,43,67,27,27,42,49,131
95687,14078,68996,3923,4336,3510,3982,5.7,6.3,5.1,20.4,2048,2048,1822,1875,2288,1688,6851
95688,9919,40147,2369,3048,2769,2433,5.9,7.6,6.9,24.7,1281,1302,1390,1088,1746,1379,4739
95689,272,1498,12,148,75,100,0.8,9.9,5.0,18.2,12,28,75,0,120,0,120
95690,407,1621,207,27,54,205,12.8,1.7,3.3,25.1,175,27,28,32,0,26,86
95691,10540,39961,2537,3050,3357,2642,6.3,7.6,8.4,26.4,1495,1712,1646,1042,1338,1711,4925
95692,1282,4887,208,369,520,243,4.3,7.6,10.6,26.2,89,93,306,119,276,214,723
95693,1322,7624,275,307,503,335,3.6,4.0,6.6,17.3,248,99,316,27,208,187,513
95694,2193,9600,506,371,603,882,5.3,3.9,6.3,22.8,185,167,224,321,204,379,1149
95695,9105,39892,2269,3093,2622,2024,5.7,7.8,6.6,22.8,1307,1423,1433,962,1670,1189,4552
95697,142,281,21,23,46,52,7.5,8.2,16.4,50.5,0,0,46,21,23,0,59
95698,29,196,15,14,0,0,7.7,7.1,0.0,14.8,15,0,0,0,14,0,14
95699,9,60,0,0,0,9,0.0,0.0,0.0,15.0,0,0,0,0,0,0,9
95701,74,1045,21,17,29,28,2.0,1.6,2.8,7.1,9,17,3,12,0,26,45
95703,109,1955,23,17,41,111,1.2,0.9,2.1,5.6,7,17,18,16,0,23,67
95709,1054,6103,307,251,344,219,5.0,4.1,5.6,17.3,134,100,160,173,151,184,612
95713,2042,10280,289,547,753,697,2.8,5.3,7.3,19.9,114,245,399,175,302,354,911
95714,72,411,8,20,23,39,1.9,4.9,5.6,17.5,8,10,13,0,10,10,29
95715,26,110,3,4,11,8,2.7,3.6,10.0,23.6,3,0,4,0,4,7,11
95717,20,129,0,14,6,15,0.0,10.9,4.7,15.5,0,0,6,0,14,0,14
95720,36,107,20,16,0,0,18.7,15.0,0.0,33.6,0,16,0,20,0,0,20
95721,0,0,0,0,0,0,,,,,0,0,0,0,0,0,0
95722,751,4829,231,184,228,187,4.8,3.8,4.7,15.6,83,153,63,148,31,165,396
95726,1392,7974,231,415,453,389,2.9,5.2,5.7,17.5,165,221,207,66,194,246,591
95728,120,549,0,22,35,105,0.0,4.0,6.4,21.9,0,11,11,0,11,24,87
95735,2,51,0,2,0,0,0.0,3.9,0.0,3.9,0,0,0,0,2,0,2
95736,0,131,0,0,0,21,0.0,0.0,0.0,0.0,0,0,0,0,0,0,0
95742,4228,14883,1122,1364,1251,635,7.5,9.2,8.4,28.4,670,752,787,452,612,464,1766
95746,5264,22743,799,1375,1777,2044,3.5,6.0,7.8,23.1,274,691,781,525,684,996,2827
95747,18839,75681,5035,4992,5396,4961,6.7,6.6,7.1,24.9,2851,2552,2810,2184,2440,2586,8717
95757,14596,53232,3333,3801,4948,4184,6.3,7.1,9.3,27.4,1680,1797,2447,1653,2004,2501,7449
95758,16573,66153,3595,4283,5479,4534,5.4,6.5,8.3,25.1,1945,2231,2911,1650,2052,2568,7833
95762,11486,45842,2604,2551,3658,3949,5.7,5.6,8.0,25.1,1297,1380,1907,1307,1171,1751,5592
95765,11470,43059,2325,3034,3757,3796,5.4,7.0,8.7,26.6,1255,1492,1959,1070,1542,1798,5566
95776,6570,26352,1652,1516,1856,2384,6.3,5.8,7.0,24.9,850,836,934,802,680,922,3189
95811,558,8456,170,160,123,307,2.0,1.9,1.5,6.6,69,73,73,101,87,50,293
95814,485,12248,142,182,115,161,1.2,1.5,0.9,4.0,24,124,100,118,58,15,235
95815,6669,26523,1691,1989,1770,1871,6.4,7.5,6.7,25.1,852,1033,1088,839,956,682,3128
95816,1293,18334,468,297,268,578,2.6,1.6,1.5,7.1,256,133,138,212,164,130,660
95817,2204,14513,691,503,752,772,4.8,3.5,5.2,15.2,370,313,319,321,190,433,1065
95818,4402,23062,1390,1098,1344,828,6.0,4.8,5.8,19.1,811,701,770,579,397,574,1864
95819,3368,19806,1034,895,896,2318,5.2,4.5,4.5,17.0,649,507,548,385,388,348,1524
95820,7403,36024,2194,1774,2041,2381,6.1,4.9,5.7,20.6,1119,774,962,1075,1000,1079,3853
95821,8265,37436,2685,2594,2147,1403,7.2,6.9,5.7,22.1,1456,1594,1107,1229,1000,1040,3764
95822,10545,46413,3140,2929,2723,2790,6.8,6.3,5.9,22.7,1554,1515,1432,1586,1414,1291,5223
95823,23542,82983,5719,6192,7121,7162,6.9,7.5,8.6,28.4,2856,2746,4078,2863,3446,3043,11455
95824,8656,30556,2032,2788,2486,2227,6.7,9.1,8.1,28.3,1072,1608,1143,960,1180,1343,4139
95825,7896,37310,2608,2546,1796,1710,7.0,6.8,4.8,21.2,1463,1476,888,1145,1070,908,3514
95826,8032,40205,2616,2247,1984,2026,6.5,5.6,4.9,20.0,1151,1094,832,1465,1153,1152,4296
95827,4839,21084,1091,1263,1699,1258,5.2,6.0,8.1,23.0,523,757,635,568,506,1064,2608
95828,14928,60850,3558,3976,4609,4634,5.8,6.5,7.6,24.5,1730,1800,2483,1828,2176,2126,7307
95829,8263,31297,2220,2466,2006,2401,7.1,7.9,6.4,26.4,1043,1236,1051,1177,1230,955,4142
95830,124,746,51,49,17,14,6.8,6.6,2.3,16.6,51,43,0,0,6,17,23
95831,8743,44450,2638,1994,2227,2474,5.9,4.5,5.0,19.7,1388,1215,1144,1250,779,1083,4214
95832,3662,13116,770,1013,1161,1140,5.9,7.7,8.9,27.9,398,618,722,372,395,439,1632
95833,9396,40908,2723,2588,2559,2409,6.7,6.3,6.3,23.0,1505,1172,1296,1218,1416,1263,4753
95834,8742,34892,2681,2639,2356,1971,7.7,7.6,6.8,25.1,1064,1574,1118,1617,1065,1238,4447
95835,9839,40957,2458,2719,2971,2679,6.0,6.6,7.3,24.0,1355,1408,1719,1103,1311,1252,4460
95837,16,306,0,0,8,8,0.0,0.0,2.6,5.2,0,0,3,0,0,5,13
95838,11497,41311,2372,3562,3770,3068,5.7,8.6,9.1,27.8,1383,1704,1885,989,1858,1885,5538
95841,4743,21542,1605,1223,1090,1251,7.5,5.7,5.1,22.0,715,590,673,890,633,417,2350
95842,9755,34775,2865,2916,2746,1976,8.2,8.4,7.9,28.1,1493,1608,1390,1372,1308,1356,4597
95843,12533,47195,3468,3375,3512,3311,7.3,7.2,7.4,26.6,1820,1626,1910,1648,1749,1602,5888
95864,5846,25728,1102,1887,1619,1896,4.3,7.3,6.3,22.7,547,946,717,555,941,902,2891
95901,9859,36119,2937,3032,2279,2491,8.1,8.4,6.3,27.3,1490,1680,1210,1447,1352,1069,4464
95903,432,1868,230,126,69,137,12.3,6.7,3.7,23.1,107,57,45,123,69,24,223
95910,0,148,0,0,0,0,0.0,0.0,0.0,0.0,0,0,0,0,0,0,0
95912,1193,4908,341,300,372,311,6.9,6.1,7.6,24.3,142,150,239,199,150,133,550
95913,52,313,0,0,37,32,0.0,0.0,11.8,16.6,0,0,37,0,0,0,15
95914,72,450,37,0,29,6,8.2,0.0,6.4,16.0,20,0,29,17,0,0,23
95915,0,0,0,0,0,0,,,,,0,0,0,0,0,0,0
95916,149,965,18,36,59,52,1.9,3.7,6.1,15.4,18,19,13,0,17,46,77
95917,1035,4091,184,319,391,417,4.5,7.8,9.6,25.3,81,186,166,103,133,225,555
95918,226,1807,69,14,82,69,3.8,0.8,4.5,12.5,30,14,43,39,0,39,139
95919,237,1183,0,174,38,32,0.0,14.7,3.2,20.0,0,0,38,0,174,0,174
95920,27,164,20,2,2,3,12.2,1.2,1.2,16.5,20,0,2,0,2,0,5
95922,86,593,37,14,16,25,6.2,2.4,2.7,14.5,6,7,16,31,7,0,48
95923,0,43,0,0,0,0,0.0,0.0,0.0,0.0,0,0,0,0,0,0,0
95925,48,188,24,24,0,0,12.8,12.8,0.0,25.5,0,0,0,24,24,0,48
95926,7415,42362,1647,2395,1889,4322,3.9,5.7,4.5,17.5,853,1205,823,794,1190,1066,3722
95928,5989,38412,1554,1777,1696,2636,4.0,4.6,4.4,15.6,696,960,962,858,817,734,2956
95929,0,0,0,0,0,0,,,,,0,0,0,0,0,0,0
95930,183,417,125,58,0,0,30.0,13.9,0.0,43.9,59,58,0,66,0,0,66
95932,2086,7789,408,630,620,549,5.2,8.1,8.0,26.8,176,409,259,232,221,361,1041
95934,0,33,0,0,0,0,0.0,0.0,0.0,0.0,0,0,0,0,0,0,0
95935,43,465,28,0,0,40,6.0,0.0,0.0,9.2,28,0,0,0,0,0,0
95936,0,121,0,0,0,0,0.0,0.0,0.0,0.0,0,0,0,0,0,0,0
95937,218,1145,112,62,0,44,9.8,5.4,0.0,19.0,79,11,0,33,51,0,128
95938,957,4451,276,198,205,452,6.2,4.4,4.6,21.5,115,134,27,161,64,178,600
95939,37,376,17,11,7,8,4.5,2.9,1.9,9.8,14,3,4,3,8,3,15
95941,85,396,38,47,0,0,9.6,11.9,0.0,21.5,36,47,0,2,0,0,2
95942,391,1786,75,19,97,200,4.2,1.1,5.4,21.9,0,0,97,75,19,0,101
95943,139,670,68,8,29,52,10.1,1.2,4.3,20.7,21,0,25,47,8,4,74
95944,0,65,0,0,0,0,0.0,0.0,0.0,0.0,0,0,0,0,0,0,0
95945,5055,27388,1194,1463,1445,1217,4.4,5.3,5.3,18.5,663,835,848,531,628,597,2294
95946,1327,9049,239,321,510,366,2.6,3.5,5.6,14.7,136,228,187,103,93,323,609
95947,306,1407,75,122,0,121,5.3,8.7,0.0,21.7,9,54,0,66,68,0,134
95948,3520,11456,870,1371,833,685,7.6,12.0,7.3,30.7,357,725,423,513,646,410,1813
95949,3101,21232,791,821,890,1057,3.7,3.9,4.2,14.6,394,395,456,397,426,434,1569
95950,99,442,15,35,38,36,3.4,7.9,8.6,22.4,15,0,38,0,35,0,35
95951,599,2522,79,108,311,217,3.1,4.3,12.3,23.8,27,29,158,52,79,153,328
95953,3175,11201,1008,715,920,852,9.0,6.4,8.2,28.3,607,416,291,401,299,629,1622
95954,2033,10163,695,519,401,539,6.8,5.1,3.9,20.0,330,343,164,365,176,237,1036
95955,354,1413,76,142,116,125,5.4,10.0,8.2,25.1,60,119,29,16,23,87,137
95956,99,458,61,38,0,17,13.3,8.3,0.0,21.6,12,18,0,49,20,0,69
95957,167,752,65,36,33,33,8.6,4.8,4.4,22.2,20,10,21,45,26,12,100
95958,0,0,0,0,0,0,,,,,0,0,0,0,0,0,0
95959,2483,18244,707,500,809,668,3.9,2.7,4.4,13.6,342,278,534,365,222,275,1092
95960,160,594,13,90,33,31,2.2,15.2,5.6,26.9,0,37,33,13,53,0,66
95961,9661,32663,2508,2958,2840,2273,7.7,9.1,8.7,29.6,1363,1483,1304,1145,1475,1536,4947
95962,132,1136,21,0,111,63,1.8,0.0,9.8,11.6,0,0,111,21,0,0,21
95963,4389,16485,1272,1117,1429,902,7.7,6.8,8.7,26.6,680,600,653,592,517,776,2219
95965,4927,20835,1317,1222,1654,1382,6.3,5.9,7.9,23.6,570,580,788,747,642,866,2585
95966,6423,30108,1937,1622,1577,1888,6.4,5.4,5.2,21.3,1221,734,658,716,888,919,3136
95968,208,1366,24,76,108,54,1.8,5.6,7.9,15.2,24,46,72,0,30,36,66
95969,1048,7564,259,183,384,366,3.4,2.4,5.1,13.9,116,83,323,143,100,61,369
95970,135,466,50,16,66,11,10.7,3.4,14.2,29.0,19,16,47,31,0,19,53
95971,983,5931,233,218,263,503,3.9,3.7,4.4,16.6,143,84,174,90,134,89,394
95972,86,142,0,0,86,0,0.0,0.0,60.6,60.6,0,0,39,0,0,47,47
95973,8474,38323,2200,2593,2427,2149,5.7,6.8,6.3,22.1,1264,1502,1276,936,1091,1151,3760
95974,0,65,0,0,0,0,0.0,0.0,0.0,0.0,0,0,0,0,0,0,0
95975,408,1628,58,53,155,142,3.6,3.3,9.5,25.1,58,21,42,0,32,113,226
95977,332,1822,0,144,151,90,0.0,7.9,8.3,18.2,0,39,114,0,105,37,149
95978,23,98,0,0,23,0,0.0,0.0,23.5,23.5,0,0,11,0,0,12,12
95979,35,374,4,5,12,21,1.1,1.3,3.2,9.4,0,0,12,4,5,0,9
95981,0,52,0,0,0,0,0.0,0.0,0.0,0.0,0,0,0,0,0,0,0
95982,729,3084,150,190,199,230,4.9,6.2,6.5,23.6,86,113,78,64,77,121,400
95983,10,395,0,10,0,11,0.0,2.5,0.0,2.5,0,10,0,0,0,0,0
95984,0,177,0,0,0,0,0.0,0.0,0.0,0.0,0,0,0,0,0,0,0
95986,0,104,0,0,0,0,0.0,0.0,0.0,0.0,0,0,0,0,0,0,0
95987,1916,6504,589,499,457,541,9.1,7.7,7.0,29.5,284,274,158,305,225,299,1016
95988,2486,8748,649,517,710,947,7.4,5.9,8.1,28.4,500,190,543,149,327,167,911
95991,12091,43978,3221,3625,3321,2892,7.3,8.2,7.6,27.5,1612,1698,1773,1609,1927,1548,5897
95993,8360,37222,1785,2469,2351,2900,4.8,6.6,6.3,22.5,919,1416,1496,866,1053,855,3603
96001,8049,34721,2138,2316,2184,2013,6.2,6.7,6.3,23.2,1360,1276,1223,778,1040,961,3472
96002,8629,34634,2288,2193,2448,2298,6.6,6.3,7.1,24.9,1020,926,1332,1268,1267,1116,4231
96003,8476,43945,1939,2707,2647,2458,4.4,6.2,6.0,19.3,1139,1272,1227,800,1435,1420,4290
96006,56,587,10,0,16,38,1.7,0.0,2.7,9.5,0,0,16,10,0,0,40
96007,5081,24849,1424,1457,1389,1217,5.7,5.9,5.6,20.4,611,697,826,813,760,563,2549
96008,205,1123,120,75,0,10,10.7,6.7,0.0,18.3,85,36,0,35,39,0,74
96009,59,247,21,24,6,26,8.5,9.7,2.4,23.9,14,0,6,7,24,0,31
96010,0,28,0,0,0,0,0.0,0.0,0.0,0.0,0,0,0,0,0,0,0
96011,70,232,1,46,23,0,0.4,19.8,9.9,30.2,0,23,18,1,23,5,29
96013,1177,4212,369,276,427,154,8.8,6.6,10.1,27.9,173,140,209,196,136,218,628
96014,40,173,0,0,29,11,0.0,0.0,16.8,23.1,0,0,0,0,0,29,29
96015,6,560,0,0,0,12,0.0,0.0,0.0,1.1,0,0,0,0,0,0,3
96016,57,319,27,30,0,0,8.5,9.4,0.0,17.9,27,30,0,0,0,0,0
96017,10,143,0,5,5,0,0.0,3.5,3.5,7.0,0,5,0,0,0,5,5
96019,2433,10466,484,724,671,818,4.6,6.9,6.4,23.2,167,422,428,317,302,243,1198
96020,362,2593,86,142,104,68,3.3,5.5,4.0,14.0,86,48,104,0,94,0,107
96021,3780,15746,1183,1106,1065,716,7.5,7.0,6.8,24.0,370,650,454,813,456,611,2154
96022,2887,14751,563,1082,870,662,3.8,7.3,5.9,19.6,339,425,372,224,657,498,1604
96023,279,1189,75,77,82,52,6.3,6.5,6.9,23.5,69,34,52,6,43,30,117
96024,315,1105,19,117,87,92,1.7,10.6,7.9,28.5,0,78,87,19,39,0,113
96025,451,2247,220,94,71,104,9.8,4.2,3.2,20.1,77,56,17,143,38,54,251
96027,345,1907,86,27,160,101,4.5,1.4,8.4,18.1,30,7,93,56,20,67,167
96028,395,1805,161,119,90,147,8.9,6.6,5.0,21.9,55,99,26,106,20,64,190
96029,42,120,8,6,10,18,6.7,5.0,8.3,35.0,4,5,5,4,1,5,20
96031,3,66,3,0,0,0,4.5,0.0,0.0,4.5,0,0,0,3,0,0,3
96032,587,2606,102,190,212,99,3.9,7.3,8.1,22.5,58,93,108,44,97,104,269
96033,60,321,12,14,26,13,3.7,4.4,8.1,18.7,7,9,18,5,5,8,20
96034,54,345,26,17,2,25,7.5,4.9,0.6,15.7,12,15,1,14,2,1,21
96035,1219,4097,462,139,317,331,11.3,3.4,7.7,29.8,426,67,239,36,72,78,310
96037,0,131,0,0,0,0,0.0,0.0,0.0,0.0,0,0,0,0,0,0,0
96038,87,499,29,20,21,23,5.8,4.0,4.2,17.4,25,6,11,4,14,10,31
96039,112,726,37,48,19,12,5.1,6.6,2.6,15.4,14,29,12,23,19,7,57
96040,0,71,0,0,0,8,0.0,0.0,0.0,0.0,0,0,0,0,0,0,0
96041,389,3511,68,43,242,76,1.9,1.2,6.9,11.1,68,43,210,0,0,32,65
96044,309,1215,102,17,110,92,8.4,1.4,9.1,25.4,25,14,25,77,3,85,182
96046,0,328,0,0,0,0,0.0,0.0,0.0,0.0,0,0,0,0,0,0,0
96047,66,843,15,9,42,0,1.8,1.1,5.0,7.8,7,7,17,8,2,25,35
96048,143,1283,56,40,37,47,4.4,3.1,2.9,11.1,21,20,22,35,20,15,70
96050,9,400,0,0,6,7,0.0,0.0,1.5,2.3,0,0,6,0,0,0,3
96051,59,1067,0,7,22,30,0.0,0.7,2.1,5.5,0,7,7,0,0,15,45
96052,611,2538,224,179,111,147,8.8,7.1,4.4,24.1,76,120,15,148,59,96,359
96054,40,269,10,12,18,0,3.7,4.5,6.7,14.9,8,5,18,2,7,0,9
96055,918,3760,233,264,219,225,6.2,7.0,5.8,24.4,128,174,133,105,90,86,371
96056,267,1318,99,43,30,95,7.5,3.3,2.3,20.3,90,25,18,9,18,12,126
96057,148,1158,0,10,92,145,0.0,0.9,7.9,12.8,0,10,71,0,0,21,33
96058,190,809,33,32,67,86,4.1,4.0,8.3,23.5,33,13,40,0,19,27,94
96059,52,323,0,0,29,23,0.0,0.0,9.0,16.1,0,0,29,0,0,0,0
96061,0,0,0,0,0,0,,,,,0,0,0,0,0,0,0
96062,95,1002,28,25,29,99,2.8,2.5,2.9,9.5,20,15,6,8,10,23,47
96063,0,77,0,0,0,0,0.0,0.0,0.0,0.0,0,0,0,0,0,0,0
96064,1011,4690,269,245,363,213,5.7,5.2,7.7,21.6,144,142,209,125,103,154,443
96065,29,364,20,0,3,6,5.5,0.0,0.8,8.0,6,0,0,14,0,3,17
96067,1226,7321,77,316,645,320,1.1,4.3,8.8,16.7,54,85,174,23,231,471,813
96068,23,125,0,0,8,15,0.0,0.0,6.4,18.4,0,0,0,0,0,8,15
96069,330,1390,24,119,140,67,1.7,8.6,10.1,23.7,7,99,68,17,20,72,141
96071,0,7,0,0,0,0,0.0,0.0,0.0,0.0,0,0,0,0,0,0,0
96073,1611,5648,443,308,457,518,7.8,5.5,8.1,28.5,124,183,301,319,125,156,825
96074,29,183,3,5,17,4,1.6,2.7,9.3,15.8,0,3,16,3,2,1,6
96075,0,341,0,0,0,0,0.0,0.0,0.0,0.0,0,0,0,0,0,0,0
96076,0,152,0,0,0,0,0.0,0.0,0.0,0.0,0,0,0,0,0,0,0
96078,37,135,0,0,0,37,0.0,0.0,0.0,27.4,0,0,0,0,0,0,37
96080,7782,31190,1712,2138,2418,2350,5.5,6.9,7.8,25.0,862,1199,1033,850,939,1385,3818
96084,99,664,14,22,48,22,2.1,3.3,7.2,14.9,8,0,25,6,22,23,61
96085,9,38,0,0,4,5,0.0,0.0,10.5,23.7,0,0,0,0,0,4,9
96086,42,268,26,4,6,6,9.7,1.5,2.2,15.7,15,0,6,11,4,0,21
96087,106,824,26,7,46,27,3.2,0.8,5.6,12.9,26,0,32,0,7,14,31
96088,488,4703,94,145,215,156,2.0,3.1,4.6,10.4,58,75,31,36,70,184,295
96090,79,421,10,28,30,15,2.4,6.7,7.1,18.8,6,14,20,4,14,10,30
96091,41,693,4,20,4,16,0.6,2.9,0.6,5.9,0,20,0,4,0,4,21
96092,83,402,8,39,30,6,2.0,9.7,7.5,20.6,0,18,8,8,21,22,51
96093,696,3959,65,335,216,206,1.6,8.5,5.5,17.6,65,40,48,0,295,168,463
96094,1222,6985,471,296,237,488,6.7,4.2,3.4,17.5,302,130,148,169,166,89,556
96096,78,784,8,8,42,42,1.0,1.0,5.4,9.9,3,2,24,5,6,18,47
96097,2494,10154,487,740,843,716,4.8,7.3,8.3,24.6,221,354,649,266,386,194,1013
96101,927,4824,311,357,148,236,6.4,7.4,3.1,19.2,168,172,46,143,185,102,498
96103,214,1340,28,0,118,93,2.1,0.0,8.8,16.0,13,0,41,15,0,77,133
96104,240,962,23,75,65,79,2.4,7.8,6.8,24.9,8,61,21,15,14,44,145
96105,103,429,0,69,0,34,0.0,16.1,0.0,24.0,0,0,0,0,69,0,69
96106,155,465,53,102,0,0,11.4,21.9,0.0,33.3,31,32,0,22,70,0,92
96107,157,868,14,42,101,8,1.6,4.8,11.6,18.1,0,42,12,14,0,89,103
96108,51,149,0,0,25,26,0.0,0.0,16.8,34.2,0,0,25,0,0,0,26
96109,216,1297,64,28,85,55,4.9,2.2,6.6,16.7,42,28,60,22,0,25,47
96110,0,37,0,0,0,0,0.0,0.0,0.0,0.0,0,0,0,0,0,0,0
96111,0,23,0,0,0,0,0.0,0.0,0.0,0.0,0,0,0,0,0,0,0
96112,29,172,14,8,7,0,8.1,4.7,4.1,16.9,9,2,3,5,6,4,15
96113,163,2164,20,53,62,37,0.9,2.4,2.9,7.5,13,27,28,7,26,34,77
96114,401,2927,113,132,151,152,3.9,4.5,5.2,13.7,14,80,89,99,52,62,213
96115,17,122,2,5,5,5,1.6,4.1,4.1,13.9,0,0,5,2,5,0,12
96116,0,19,0,0,0,0,0.0,0.0,0.0,0.0,0,0,0,0,0,0,0
96117,127,288,39,70,18,0,13.5,24.3,6.3,44.1,6,20,18,33,50,0,83
96118,233,1581,0,84,104,45,0.0,5.3,6.6,14.7,0,84,71,0,0,33,72
96119,15,31,0,0,15,0,0.0,0.0,48.4,48.4,0,0,0,0,0,15,15
96120,245,1209,77,53,55,122,6.4,4.4,4.5,20.3,35,33,38,42,20,17,103
96121,0,145,0,0,0,0,0.0,0.0,0.0,0.0,0,0,0,0,0,0,0
96122,777,4121,249,226,244,115,6.0,5.5,5.9,18.9,111,136,144,138,90,100,364
96123,17,62,12,5,0,0,19.4,8.1,0.0,27.4,12,5,0,0,0,0,0
96124,122,320,0,35,74,13,0.0,10.9,23.1,38.1,0,0,32,0,35,42,77
96125,0,234,0,0,0,0,0.0,0.0,0.0,0.0,0,0,0,0,0,0,0
96126,41,227,0,0,41,55,0.0,0.0,18.1,18.1,0,0,0,0,0,41,41
96128,225,600,60,101,11,54,10.0,16.8,1.8,37.5,47,37,11,13,64,0,78
96129,217,640,57,81,0,79,8.9,12.7,0.0,33.9,57,81,0,0,0,0,0
96130,3690,21460,987,981,1123,913,4.6,4.6,5.2,17.2,434,535,508,553,446,615,1871
96132,0,17,0,0,0,0,0.0,0.0,0.0,0.0,0,0,0,0,0,0,0
96133,0,188,0,0,0,21,0.0,0.0,0.0,0.0,0,0,0,0,0,0,0
96134,535,2236,154,173,160,107,6.9,7.7,7.2,23.9,76,77,72,78,96,88,300
96135,0,106,0,0,0,0,0.0,0.0,0.0,0.0,0,0,0,0,0,0,0
96136,16,40,0,0,0,16,0.0,0.0,0.0,40.0,0,0,0,0,0,0,16
96137,455,2949,151,114,113,115,5.1,3.9,3.8,15.4,99,80,47,52,34,66,216
96140,190,1219,10,21,124,46,0.8,1.7,10.2,15.6,0,0,30,10,21,94,160
96141,67,592,7,10,10,61,1.2,1.7,1.7,11.3,3,4,3,4,6,7,41
96142,119,946,49,34,31,14,5.2,3.6,3.3,12.6,15,24,14,34,10,17,61
96143,675,3130,56,283,225,111,1.8,9.0,7.2,21.6,0,114,115,56,169,110,405
96145,597,3081,273,132,145,70,8.9,4.3,4.7,19.4,107,81,38,166,51,107,346
96146,97,1147,32,34,11,20,2.8,3.0,1.0,8.5,26,0,11,6,34,0,40
96148,69,630,19,24,26,0,3.0,3.8,4.1,11.0,19,12,12,0,12,14,26
96150,4779,29457,1314,1254,1450,1479,4.5,4.3,4.9,16.2,669,564,715,645,690,735,2537
96155,0,0,0,0,0,0,,,,,0,0,0,0,0,0,0
96161,4062,19146,1176,1097,1174,932,6.1,5.7,6.1,21.2,647,508,553,529,589,621,2106
97635,123,345,8,0,115,0,2.3,0.0,33.3,35.7,0,0,16,8,0,99,107
