ZIP Code,Population Under 18 years,Total Population,Percent Population Under 18 years,Female Population Under 18 years,Male Population Under 18 years
89010,71,461,15.4,36,35
89019,146,2312,6.3,109,37
89060,1917,12198,15.7,1343,574
89061,971,7529,12.9,308,663
89439,192,1639,11.7,69,123
90001,17012,57652,29.5,8721,8291
90002,15282,53108,28.8,7390,7892
90003,23588,75024,31.4,10560,13028
90004,10842,58833,18.4,4922,5920
90005,6565,37754,17.4,3074,3491
90006,11210,56628,19.8,6064,5146
90007,5377,41004,13.1,2723,2654
90008,5777,33076,17.5,3145,2632
90010,180,4185,4.3,115,65
90011,30173,106042,28.5,14284,15889
90012,3144,38430,8.2,1186,1958
90013,341,14587,2.3,183,158
90014,426,9273,4.6,139,287
90015,3477,25554,13.6,1750,1727
90016,9984,47309,21.1,4383,5601
90017,5743,28754,20.0,2583,3160
90018,10479,49898,21.0,4800,5679
90019,10146,59410,17.1,4981,5165
90020,6479,38400,16.9,3120,3359
90021,369,2781,13.3,172,197
90022,15403,64147,24.0,7296,8107
90023,13155,44558,29.5,6235,6920
90024,3407,50392,6.8,1927,1480
90025,4744,44429,10.7,1909,2835
90026,9862,64769,15.2,4837,5025
90027,5519,45764,12.1,2645,2874
90028,2256,30982,7.3,1431,825
90029,5346,34649,15.4,2738,2608
90031,7147,37457,19.1,3516,3631
90032,8955,44881,20.0,3897,5058
90033,12086,47655,25.4,5959,6127
90034,7411,55061,13.5,3933,3478
90035,5421,26595,20.4,2723,2698
90036,5389,37713,14.3,2344,3045
90037,18249,69064,26.4,9249,9000
90038,3527,27979,12.6,1645,1882
90039,3674,28244,13.0,1701,1973
90040,2510,11839,21.2,1285,1225
90041,5107,28321,18.0,2274,2833
90042,10131,59151,17.1,5082,5049
90043,8905,44461,20.0,4374,4531
90044,29348,98990,29.6,13922,15426
90045,6206,41123,15.1,2968,3238
90046,3500,48170,7.3,1621,1879
90047,11834,52200,22.7,5327,6507
90048,1840,20411,9.0,754,1086
90049,6401,35819,17.9,3055,3346
90052,0,0,,0,0
90056,1711,8225,20.8,833,878
90057,10044,47142,21.3,5146,4898
90058,731,3049,24.0,321,410
90059,12445,39471,31.5,6061,6384
90061,8031,28646,28.0,3934,4097
90062,7184,33528,21.4,3584,3600
90063,12316,52008,23.7,5877,6439
90064,4765,25956,18.4,2245,2520
90065,7936,44897,17.7,3840,4096
90066,8589,54142,15.9,4229,4360
90067,291,2653,11.0,155,136
90068,2216,21064,10.5,904,1312
90069,1233,20045,6.2,544,689
90071,0,313,0.0,0,0
90073,0,1014,0.0,0,0
90077,1839,7868,23.4,997,842
90079,0,0,,0,0
90089,90,4164,2.2,68,22
90094,2470,11891,20.8,1596,874
90095,0,0,,0,0
90201,25850,95134,27.2,12706,13144
90210,3513,19180,18.3,1643,1870
90211,1825,9208,19.8,1025,800
90212,1443,10881,13.3,762,681
90220,14012,49101,28.5,7169,6843
90221,14108,52119,27.1,6944,7164
90222,9080,33021,27.5,4644,4436
90230,6813,32005,21.3,3190,3623
90232,2926,16352,17.9,1328,1598
90240,6036,26026,23.2,3367,2669
90241,10175,45341,22.4,5079,5096
90242,9294,41685,22.3,4757,4537
90245,3550,17081,20.8,1860,1690
90247,9593,47682,20.1,4810,4783
90248,1670,11453,14.6,1022,648
90249,5208,25929,20.1,2669,2539
90250,24046,96200,25.0,11494,12552
90254,3779,19551,19.3,1735,2044
90255,17925,71654,25.0,8383,9542
90260,7662,33282,23.0,3981,3681
90262,17157,66073,26.0,7974,9183
90263,14,1803,0.8,9,5
90265,3142,16652,18.9,1223,1919
90266,9408,35123,26.8,4715,4693
90270,6906,24950,27.7,3166,3740
90272,5562,21298,26.1,2867,2695
90274,5487,24942,22.0,2824,2663
90275,8779,41941,20.9,4192,4587
90277,6939,36339,19.1,3555,3384
90278,10659,42536,25.1,5405,5254
90280,22875,92262,24.8,11408,11467
90290,1053,5300,19.9,547,506
90291,3181,25656,12.4,1477,1704
90292,2988,24481,12.2,1432,1556
90293,1249,13039,9.6,481,768
90301,7690,37341,20.6,3896,3794
90302,6292,29307,21.5,3131,3161
90303,5733,23370,24.5,2688,3045
90304,6369,25725,24.8,2943,3426
90305,2380,14679,16.2,1263,1117
90401,315,7480,4.2,101,214
90402,2785,11816,23.6,1279,1506
90403,3179,24092,13.2,1501,1678
90404,3985,23975,16.6,1776,2209
90405,4012,26981,14.9,1681,2331
90501,9646,42536,22.7,4740,4906
90502,2926,18430,15.9,1506,1420
90503,8876,44280,20.0,3735,5141
90504,6639,32965,20.1,3231,3408
90505,8553,36214,23.6,4335,4218
90506,0,0,,0,0
90601,6056,30667,19.7,3175,2881
90602,6719,25949,25.9,3228,3491
90603,4471,20883,21.4,2099,2372
90604,9684,39795,24.3,4848,4836
90605,9459,41427,22.8,4465,4994
90606,6891,31717,21.7,3510,3381
90620,10230,47042,21.7,4823,5407
90621,8012,36151,22.2,4170,3842
90623,2991,15419,19.4,1356,1635
90630,11656,50170,23.2,6158,5498
90631,14887,69064,21.6,6753,8134
90638,9128,46170,19.8,4224,4904
90639,19,1833,1.0,19,0
90640,13043,62294,20.9,6890,6153
90650,23294,101983,22.8,11267,12027
90660,12853,61561,20.9,6430,6423
90670,3714,17556,21.2,1988,1726
90680,6961,31102,22.4,3760,3201
90701,3208,16237,19.8,1669,1539
90703,9127,49334,18.5,3965,5162
90704,820,3822,21.5,432,388
90706,18465,78352,23.6,9624,8841
90710,6188,27517,22.5,3298,2890
90712,6917,31552,21.9,3207,3710
90713,5603,28439,19.7,2609,2994
90715,4157,20949,19.8,2136,2021
90716,3574,13941,25.6,1897,1677
90717,4361,21788,20.0,2087,2274
90720,5812,23673,24.6,2718,3094
90723,14273,53286,26.8,6840,7433
90731,13715,63431,21.6,7065,6650
90732,3917,22078,17.7,1938,1979
90740,3293,24604,13.4,1615,1678
90742,27,469,5.8,12,15
90743,53,434,12.2,28,25
90744,15200,54277,28.0,6539,8661
90745,11794,58735,20.1,5723,6071
90746,4887,27643,17.7,2469,2418
90747,0,25,0.0,0,0
90755,2277,11764,19.4,1061,1216
90802,5186,40012,13.0,2661,2525
90803,3309,31659,10.5,1485,1824
90804,6574,37299,17.6,3044,3530
90805,24626,96515,25.5,12055,12571
90806,9445,40688,23.2,4104,5341
90807,6452,33153,19.5,3061,3391
90808,8805,39698,22.2,4062,4743
90810,8040,36306,22.1,3809,4231
90813,13633,53647,25.4,6563,7070
90814,3814,20723,18.4,1944,1870
90815,8301,42759,19.4,3846,4455
90822,0,125,0.0,0,0
90831,0,0,,0,0
90840,0,0,,0,0
91001,7394,36420,20.3,3863,3531
91006,6789,31986,21.2,3610,3179
91007,6498,33367,19.5,3447,3051
91008,90,744,12.1,46,44
91010,4747,26825,17.7,1973,2774
91011,5674,20389,27.8,2982,2692
91016,9276,41822,22.2,4261,5015
91020,1843,7509,24.5,987,856
91024,2033,11151,18.2,1000,1033
91030,6136,26583,23.1,2804,3332
91040,3853,20911,18.4,1771,2082
91042,4455,27119,16.4,2355,2100
91046,0,141,0.0,0,0
91101,2037,19737,10.3,966,1071
91103,5747,27167,21.2,2683,3064
91104,7013,35918,19.5,3242,3771
91105,1977,12692,15.6,890,1087
91106,3751,23813,15.8,1935,1816
91107,5984,32581,18.4,2973,3011
91108,2894,12559,23.0,1318,1576
91125,3,996,0.3,0,3
91201,4162,22163,18.8,2308,1854
91202,3634,22831,15.9,1846,1788
91203,2735,16679,16.4,1225,1510
91204,3127,18445,17.0,1595,1532
91205,6245,35755,17.5,3419,2826
91206,5259,32294,16.3,2535,2724
91207,2130,11091,19.2,972,1158
91208,2828,15377,18.4,1641,1187
91210,35,310,11.3,0,35
91214,8071,32344,25.0,3734,4337
91301,5923,25244,23.5,2752,3171
91302,5706,26318,21.7,2928,2778
91303,6392,30611,20.9,3111,3281
91304,11244,54369,20.7,5613,5631
91306,10778,49460,21.8,5031,5747
91307,5395,25368,21.3,2912,2483
91311,7921,40196,19.7,3937,3984
91316,5371,28497,18.8,3033,2338
91320,10299,44138,23.3,5044,5255
91321,8885,34305,25.9,5204,3681
91324,5744,29744,19.3,2506,3238
91325,6264,35537,17.6,3386,2878
91326,7655,36503,21.0,3721,3934
91330,30,2699,1.1,19,11
91331,24450,99804,24.5,11844,12606
91335,16435,77158,21.3,8066,8369
91340,8081,34822,23.2,3949,4132
91342,20896,92580,22.6,9523,11373
91343,15378,63193,24.3,7549,7829
91344,10828,53862,20.1,5138,5690
91345,3278,18481,17.7,1719,1559
91350,12160,42970,28.3,5952,6208
91351,7827,32677,24.0,3457,4370
91352,9628,45601,21.1,5064,4564
91354,8574,33039,26.0,4492,4082
91355,5668,30289,18.7,2630,3038
91356,5851,30599,19.1,2755,3096
91360,7860,42444,18.5,3538,4322
91361,3432,18753,18.3,1421,2011
91362,7123,36770,19.4,3216,3907
91364,6567,28765,22.8,3306,3261
91367,8049,44862,17.9,3671,4378
91371,0,0,,0,0
91377,3423,13627,25.1,1605,1818
91381,5578,20864,26.7,3350,2228
91384,6449,27652,23.3,3121,3328
91387,12666,46812,27.1,5883,6783
91390,4368,18930,23.1,2377,1991
91401,7474,39179,19.1,3531,3943
91402,16688,67937,24.6,7788,8900
91403,4306,25887,16.6,1719,2587
91405,12361,55451,22.3,6146,6215
91406,12035,53276,22.6,5953,6082
91411,4664,23689,19.7,2186,2478
91423,4991,31787,15.7,2405,2586
91436,3479,16190,21.5,1644,1835
91501,3256,18951,17.2,1420,1836
91502,2067,12312,16.8,1059,1008
91504,5789,27479,21.1,2682,3107
91505,6350,32156,19.7,3273,3077
91506,3387,19559,17.3,1553,1834
91601,4630,35615,13.0,2229,2401
91602,2432,19980,12.2,1072,1360
91604,5480,32073,17.1,2792,2688
91605,10529,51654,20.4,5109,5420
91606,8277,43552,19.0,3811,4466
91607,5192,30734,16.9,2737,2455
91608,0,56,0.0,0,0
91701,7922,39323,20.1,3656,4266
91702,12966,62196,20.8,6292,6674
91706,15377,72495,21.2,7647,7730
91708,4704,15908,29.6,2343,2361
91709,17346,78341,22.1,7731,9615
91710,17768,81466,21.8,8428,9340
91711,6245,37542,16.6,3222,3023
91722,7118,34470,20.6,3303,3815
91723,3651,17964,20.3,1752,1899
91724,5889,28575,20.6,2731,3158
91730,16581,71040,23.3,8538,8043
91731,6486,28201,23.0,2946,3540
91732,13197,58888,22.4,6696,6501
91733,9696,42953,22.6,4493,5203
91737,5043,23108,21.8,2179,2864
91739,10068,41319,24.4,4321,5747
91740,6196,27131,22.8,3408,2788
91741,5693,26052,21.9,2816,2877
91744,17843,79380,22.5,8220,9623
91745,10417,55489,18.8,5499,4918
91746,6037,29429,20.5,3101,2936
91748,7960,43851,18.2,3801,4159
91750,6574,33436,19.7,3169,3405
91752,8960,37173,24.1,4756,4204
91754,5908,33937,17.4,3017,2891
91755,4479,26418,17.0,2170,2309
91759,36,299,12.0,15,21
91761,14878,61837,24.1,7893,6985
91762,16006,62990,25.4,7942,8064
91763,9570,37698,25.4,5068,4502
91764,13782,55311,24.9,7022,6760
91765,8805,45303,19.4,4474,4331
91766,17123,69517,24.6,8697,8426
91767,12372,50715,24.4,6344,6028
91768,7804,35443,22.0,4187,3617
91770,11041,59410,18.6,4985,6056
91773,6833,34066,20.1,3513,3320
91775,4697,24169,19.4,2168,2529
91776,6580,37340,17.6,2899,3681
91780,7577,35556,21.3,3878,3699
91784,5062,26116,19.4,2762,2300
91786,12589,56025,22.5,6437,6152
91789,7779,41377,18.8,4124,3655
91790,9802,44855,21.9,4683,5119
91791,6011,33902,17.7,2852,3159
91792,5781,31208,18.5,2948,2833
91801,8984,53320,16.8,4655,4329
91803,5619,29006,19.4,2739,2880
91901,3982,18669,21.3,2136,1846
91902,2860,17121,16.7,1428,1432
91905,101,1411,7.2,54,47
91906,1370,4281,32.0,549,821
91910,16142,76313,21.2,8175,7967
91911,21272,87799,24.2,10800,10472
91913,15361,56102,27.4,8099,7262
91914,4256,17373,24.5,1843,2413
91915,10966,35608,30.8,5110,5856
91916,338,1833,18.4,154,184
91917,351,851,41.2,226,125
91931,241,749,32.2,172,69
91932,5846,26157,22.3,2807,3039
91934,118,1251,9.4,37,81
91935,1869,9320,20.1,908,961
91941,6738,33602,20.1,3127,3611
91942,8475,40995,20.7,4185,4290
91945,6018,27541,21.9,2918,3100
91948,0,104,0.0,0,0
91950,13018,57844,22.5,6416,6602
91962,417,2528,16.5,202,215
91963,156,624,25.0,79,77
91977,16264,65497,24.8,8064,8200
91978,2542,11006,23.1,1396,1146
91980,17,103,16.5,0,17
92003,767,4404,17.4,381,386
92004,344,3200,10.8,168,176
92007,3071,11939,25.7,1023,2048
92008,4453,27373,16.3,2023,2430
92009,12293,46334,26.5,6025,6268
92010,3682,16566,22.2,1529,2153
92011,5682,24472,23.2,2730,2952
92014,2029,12532,16.2,748,1281
92019,10482,45937,22.8,4877,5605
92020,14033,59775,23.5,7283,6750
92021,17270,69638,24.8,8576,8694
92024,9894,50222,19.7,5159,4735
92025,12109,50270,24.1,6237,5872
92026,11254,53053,21.2,4645,6609
92027,13069,55750,23.4,6554,6515
92028,12453,51135,24.4,6004,6449
92029,3898,19986,19.5,1987,1911
92036,281,3075,9.1,124,157
92037,6225,37665,16.5,2585,3640
92040,10332,45906,22.5,5739,4593
92054,6901,37050,18.6,3325,3576
92055,0,10618,0.0,0,0
92056,11634,54190,21.5,5597,6037
92057,13080,58022,22.5,6634,6446
92058,12414,48272,25.7,6314,6100
92059,477,1456,32.8,327,150
92060,0,506,0.0,0,0
92061,186,1677,11.1,120,66
92064,10841,48783,22.2,5138,5703
92065,8103,36836,22.0,3546,4557
92066,42,319,13.2,27,15
92067,2250,9186,24.5,1415,835
92069,11473,46648,24.6,5492,5981
92070,120,761,15.8,39,81
92071,13657,59795,22.8,6152,7505
92075,2372,12072,19.6,1233,1139
92078,13566,53019,25.6,6200,7366
92081,6494,29475,22.0,3327,3167
92082,4830,20678,23.4,2422,2408
92083,9225,37864,24.4,4677,4548
92084,12046,49971,24.1,5346,6700
92086,163,1409,11.6,111,52
92091,211,1288,16.4,109,102
92092,0,521,0.0,0,0
92093,0,2044,0.0,0,0
92096,0,0,,0,0
92101,2090,46025,4.5,966,1124
92102,8476,40051,21.2,4201,4275
92103,2979,34296,8.7,1502,1477
92104,6694,46613,14.4,3484,3210
92105,17282,72688,23.8,8380,8902
92106,3796,20483,18.5,2078,1718
92107,4158,29435,14.1,2142,2016
92108,2842,24201,11.7,1189,1653
92109,4528,44009,10.3,2118,2410
92110,4526,30773,14.7,2225,2301
92111,8256,47710,17.3,4385,3871
92113,14147,50983,27.7,6889,7258
92114,14051,66487,21.1,6214,7837
92115,10454,61456,17.0,5116,5338
92116,3581,31836,11.2,1745,1836
92117,9556,54499,17.5,4277,5279
92118,3259,17602,18.5,1596,1663
92119,5004,24419,20.5,2616,2388
92120,6267,30241,20.7,2978,3289
92121,613,4150,14.8,336,277
92122,6054,45988,13.2,2734,3320
92123,5933,32951,18.0,2637,3296
92124,8543,31121,27.5,4352,4191
92126,15401,78111,19.7,7586,7815
92127,14428,51107,28.2,7039,7389
92128,9413,49273,19.1,4499,4914
92129,12267,52495,23.4,6155,6112
92130,15484,57363,27.0,7608,7876
92131,9365,35227,26.6,4472,4893
92132,0,0,,0,0
92134,0,241,0.0,0,0
92135,0,1095,0.0,0,0
92136,6,9630,0.1,0,6
92139,7862,34930,22.5,4160,3702
92140,30,2807,1.1,0,30
92145,0,2810,0.0,0,0
92147,0,180,0.0,0,0
92154,19045,83758,22.7,8979,10066
92155,0,196,0.0,0,0
92161,0,12,0.0,0,0
92173,7195,28609,25.1,3591,3604
92179,0,3031,0.0,0,0
92182,0,0,,0,0
92201,13834,64325,21.5,6919,6915
92203,8130,33558,24.2,4062,4068
92210,286,4832,5.9,83,203
92211,3129,26741,11.7,1700,1429
92220,7503,32797,22.9,3342,4161
92222,0,0,,0,0
92223,17554,61686,28.5,8262,9292
92225,4610,21189,21.8,2234,2376
92227,8222,27540,29.9,4101,4121
92230,343,2039,16.8,176,167
92231,11135,38674,28.8,5300,5835
92233,1109,6871,16.1,575,534
92234,10485,51964,20.2,5547,4938
92236,9415,42506,22.1,4284,5131
92239,16,296,5.4,5,11
92240,10575,40755,25.9,5238,5337
92241,1251,8232,15.2,785,466
92242,176,1230,14.3,47,129
92243,14520,49193,29.5,7061,7459
92249,2269,7910,28.7,1031,1238
92250,2161,8033,26.9,1083,1078
92251,7975,27050,29.5,4071,3904
92252,1384,7911,17.5,901,483
92253,6932,37898,18.3,2569,4363
92254,1728,9362,18.5,947,781
92256,633,3387,18.7,284,349
92257,389,1186,32.8,228,161
92258,107,547,19.6,55,52
92259,0,225,0.0,0,0
92260,4186,31039,13.5,2224,1962
92262,2941,25856,11.4,1190,1751
92264,1186,20229,5.9,501,685
92266,0,170,0.0,0,0
92267,0,0,,0,0
92268,0,405,0.0,0,0
92270,1493,17257,8.7,646,847
92273,447,1631,27.4,233,214
92274,3027,15917,19.0,1603,1424
92275,363,1406,25.8,161,202
92276,2257,8242,27.4,1342,915
92277,8194,27370,29.9,3848,4346
92278,0,3574,0.0,0,0
92280,0,0,,0,0
92281,831,2238,37.1,393,438
92282,255,1361,18.7,139,116
92283,662,1967,33.7,332,330
92284,5949,25741,23.1,3010,2939
92285,216,2726,7.9,108,108
92301,12849,38565,33.3,6064,6785
92304,0,0,,0,0
92305,202,500,40.4,112,90
92307,10693,40534,26.4,4817,5876
92308,13210,43191,30.6,6525,6685
92309,159,561,28.3,82,77
92310,2671,8967,29.8,1301,1370
92311,10378,34226,30.3,4988,5390
92313,2803,13104,21.4,1337,1466
92314,2385,10658,22.4,1079,1306
92315,1134,5228,21.7,509,625
92316,7968,30656,26.0,3045,4923
92317,46,567,8.1,10,36
92320,2251,10366,21.7,960,1291
92321,158,784,20.2,107,51
92322,89,746,11.9,30,59
92324,14007,57593,24.3,7185,6822
92325,1630,8449,19.3,831,799
92327,86,633,13.6,26,60
92328,56,1022,5.5,0,56
92332,21,177,11.9,21,0
92333,34,429,7.9,6,28
92335,27803,96704,28.8,13127,14676
92336,27833,100571,27.7,13447,14386
92337,9497,37292,25.5,4748,4749
92338,0,0,,0,0
92339,313,1064,29.4,47,266
92341,56,331,16.9,36,20
92342,1409,6317,22.3,693,716
92344,5136,20448,25.1,2227,2909
92345,25665,87476,29.3,12748,12917
92346,15638,60025,26.1,7233,8405
92347,105,601,17.5,23,82
92350,0,468,0.0,0,0
92352,1220,6147,19.8,526,694
92354,4349,23054,18.9,2306,2043
92356,1719,7048,24.4,794,925
92358,49,762,6.4,7,42
92359,2414,9758,24.7,997,1417
92363,1127,5447,20.7,583,544
92364,0,12,0.0,0,0
92365,469,2393,19.6,162,307
92368,276,1018,27.1,156,120
92369,34,3999,0.9,0,34
92371,6472,21265,30.4,3542,2930
92372,1378,5208,26.5,756,622
92373,7473,33946,22.0,3740,3733
92374,10488,44976,23.3,4848,5640
92376,23625,85727,27.6,11829,11796
92377,5336,20935,25.5,2666,2670
92378,110,437,25.2,65,45
92382,1277,4884,26.1,611,666
92384,0,23,0.0,0,0
92385,0,167,0.0,0,0
92386,426,2064,20.6,317,109
92389,0,187,0.0,0,0
92391,411,2177,18.9,197,214
92392,18638,61859,30.1,9303,9335
92394,11843,39939,29.7,5689,6154
92395,14226,48479,29.3,6739,7487
92397,908,5059,17.9,384,524
92398,166,1394,11.9,60,106
92399,13997,55236,25.3,7389,6608
92401,546,2060,26.5,275,271
92404,18370,64090,28.7,8728,9642
92405,10154,31550,32.2,4877,5277
92407,18872,67207,28.1,9904,8968
92408,3016,12478,24.2,1553,1463
92410,14139,48398,29.2,6834,7305
92411,8019,26915,29.8,4026,3993
92415,0,0,,0,0
92501,5060,22136,22.9,2164,2896
92503,23332,88617,26.3,11648,11684
92504,12640,57636,21.9,5646,6994
92505,13037,52696,24.7,6650,6387
92506,10843,44344,24.5,4853,5990
92507,11579,60949,19.0,5238,6341
92508,9544,36500,26.1,5028,4516
92509,21134,80325,26.3,10463,10671
92518,314,1132,27.7,128,186
92521,0,0,,0,0
92530,16215,58249,27.8,8493,7722
92532,7837,27454,28.5,2792,5045
92536,439,2569,17.1,287,152
92539,790,3760,21.0,352,438
92543,9627,38403,25.1,4601,5026
92544,13920,51567,27.0,7076,6844
92545,10196,45219,22.5,4865,5331
92548,1968,7110,27.7,989,979
92549,506,3535,14.3,208,298
92551,9692,36326,26.7,4495,5197
92553,21327,73945,28.8,11091,10236
92555,11273,44923,25.1,5528,5745
92557,14335,54936,26.1,7197,7138
92561,245,1622,15.1,118,127
92562,17231,64155,26.9,8299,8932
92563,21431,78139,27.4,11100,10331
92567,3290,10721,30.7,1820,1470
92570,16063,58275,27.6,8080,7983
92571,18283,59896,30.5,9361,8922
92582,7192,21961,32.7,3316,3876
92583,9066,33781,26.8,4587,4479
92584,15518,54663,28.4,8070,7448
92585,7705,27083,28.4,3268,4437
92586,2809,20152,13.9,1244,1565
92587,5139,18926,27.2,2229,2910
92590,1108,5212,21.3,535,573
92591,10048,41047,24.5,4742,5306
92592,23491,81636,28.8,11834,11657
92595,8130,34698,23.4,3778,4352
92596,11615,35726,32.5,5651,5964
92602,7086,26663,26.6,3867,3219
92603,3706,19329,19.2,1860,1846
92604,5971,29080,20.5,2998,2973
92606,5293,24431,21.7,2784,2509
92610,2609,13107,19.9,1316,1293
92612,4112,34868,11.8,2167,1945
92614,6884,29544,23.3,3055,3829
92617,2194,20432,10.7,1141,1053
92618,14473,59386,24.4,6225,8248
92620,16595,61110,27.2,7989,8606
92624,1254,6881,18.2,813,441
92625,2250,12546,17.9,1231,1019
92626,8713,50198,17.4,4446,4267
92627,12731,62181,20.5,6388,6343
92629,4644,26144,17.8,1838,2806
92630,13406,66240,20.2,6149,7257
92637,51,17452,0.3,16,35
92646,10328,56033,18.4,4883,5445
92647,11319,60114,18.8,5619,5700
92648,8099,45667,17.7,3729,4370
92649,5519,35206,15.7,2488,3031
92651,3658,23981,15.3,1785,1873
92653,5766,29923,19.3,2712,3054
92655,1718,8040,21.4,775,943
92656,12893,53143,24.3,6648,6245
92657,2182,9169,23.8,1101,1081
92660,7149,35926,19.9,3457,3692
92661,351,3300,10.6,105,246
92662,184,2346,7.8,77,107
92663,2181,21886,10.0,881,1300
92672,6889,38020,18.1,3414,3475
92673,8487,30633,27.7,3496,4991
92675,8112,35099,23.1,4358,3754
92676,461,1952,23.6,287,174
92677,10919,64259,17.0,5032,5887
92678,95,630,15.1,45,50
92679,6635,30971,21.4,3462,3173
92683,19219,90630,21.2,10180,9039
92688,10750,44444,24.2,5185,5565
92691,9773,48073,20.3,4827,4946
92692,8830,45977,19.2,4451,4379
92694,11862,35074,33.8,5920,5942
92697,0,0,,0,0
92701,13624,49462,27.5,5922,7702
92703,14234,61593,23.1,6541,7693
92704,18619,80767,23.1,9443,9176
92705,11274,46854,24.1,5607,5667
92706,8416,36548,23.0,3938,4478
92707,13834,59712,23.2,7074,6760
92708,10939,56754,19.3,5080,5859
92780,13422,54945,24.4,6114,7308
92782,6769,29838,22.7,2827,3942
92801,14850,64022,23.2,7115,7735
92802,11510,44316,26.0,5202,6308
92804,18664,84700,22.0,9704,8960
92805,17636,73310,24.1,9469,8167
92806,9431,40945,23.0,4435,4996
92807,7287,36117,20.2,3522,3765
92808,4320,21080,20.5,2012,2308
92821,9078,41604,21.8,4742,4336
92823,1352,5495,24.6,765,587
92831,6638,36470,18.2,2766,3872
92832,6686,26040,25.7,3617,3069
92833,12433,52799,23.5,6047,6386
92835,6079,26687,22.8,3657,2422
92840,11540,53826,21.4,5798,5742
92841,7301,34188,21.4,3588,3713
92843,10572,47549,22.2,5220,5352
92844,4169,22622,18.4,2139,2030
92845,3086,15530,19.9,1271,1815
92860,4588,25367,18.1,2104,2484
92861,1228,5814,21.1,565,663
92865,4619,21140,21.8,2047,2572
92866,2649,14873,17.8,1088,1561
92867,9521,44216,21.5,4431,5090
92868,5040,27280,18.5,2582,2458
92869,7669,36429,21.1,3742,3927
92870,12575,53150,23.7,6223,6352
92879,11673,49111,23.8,5485,6188
92880,21465,74645,28.8,10307,11158
92881,7429,31401,23.7,3154,4275
92882,17363,69472,25.0,8744,8619
92883,9341,37211,25.1,4990,4351
92886,12023,50437,23.8,5902,6121
92887,4042,20353,19.9,1935,2107
93001,6034,31751,19.0,3376,2658
93003,11314,53283,21.2,5667,5647
93004,6234,31151,20.0,2915,3319
93010,10258,47656,21.5,4577,5681
93012,6459,36145,17.9,3069,3390
93013,3228,16459,19.6,1552,1676
93015,4682,18716,25.0,2611,2071
93021,8813,37980,23.2,4495,4318
93022,1271,6422,19.8,646,625
93023,3297,21279,15.5,1535,1762
93030,14918,58511,25.5,7027,7891
93033,24204,82517,29.3,12216,11988
93035,5264,26286,20.0,2612,2652
93036,11750,46959,25.0,5837,5913
93040,484,1838,26.3,286,198
93041,5704,23108,24.7,2934,2770
93042,0,107,0.0,0,0
93043,0,722,0.0,0,0
93060,9194,34337,26.8,4777,4417
93063,10848,57075,19.0,5430,5418
93064,0,0,,0,0
93065,15311,72086,21.2,7439,7872
93066,436,2805,15.5,202,234
93067,235,999,23.5,104,131
93101,5547,29870,18.6,2392,3155
93103,3447,19653,17.5,1861,1586
93105,4268,26482,16.1,1770,2498
93106,88,5369,1.6,45,43
93108,1473,11209,13.1,800,673
93109,1542,11626,13.3,830,712
93110,2899,16403,17.7,1282,1617
93111,3802,18165,20.9,1989,1813
93117,7380,53345,13.8,3454,3926
93201,478,1209,39.5,306,172
93202,1489,4308,34.6,614,875
93203,7485,20781,36.0,3718,3767
93204,3781,13423,28.2,1947,1834
93205,535,2320,23.1,165,370
93206,616,1709,36.0,306,310
93207,52,232,22.4,21,31
93208,0,127,0.0,0,0
93210,4596,18937,24.3,2517,2079
93212,5026,23391,21.5,2686,2340
93215,13257,53334,24.9,5511,7746
93218,309,796,38.8,186,123
93219,3093,9871,31.3,1542,1551
93220,0,0,,0,0
93221,3982,14423,27.6,1990,1992
93222,296,2036,14.5,63,233
93223,2994,10424,28.7,1533,1461
93224,152,501,30.3,85,67
93225,839,5018,16.7,357,482
93226,0,55,0.0,0,0
93227,44,227,19.4,0,44
93230,19377,68572,28.3,9622,9755
93234,2275,6571,34.6,1249,1026
93235,1346,4360,30.9,633,713
93237,2,98,2.0,1,1
93238,220,866,25.4,76,144
93239,331,1404,23.6,173,158
93240,1385,5470,25.3,596,789
93241,5384,15978,33.7,2560,2824
93242,858,2683,32.0,382,476
93243,126,977,12.9,56,70
93244,16,121,13.2,6,10
93245,10168,37439,27.2,4811,5357
93246,0,1129,0.0,0,0
93247,5518,17827,31.0,2619,2899
93249,749,1996,37.5,327,422
93250,5203,15126,34.4,2594,2609
93251,80,293,27.3,37,43
93252,424,1680,25.2,242,182
93254,192,869,22.1,133,59
93255,0,872,0.0,0,0
93256,1776,5575,31.9,766,1010
93257,23865,79217,30.1,11417,12448
93258,206,1086,19.0,113,93
93260,40,178,22.5,12,28
93261,591,1889,31.3,324,267
93262,0,18,0.0,0,0
93263,7631,22952,33.2,4137,3494
93265,622,3194,19.5,309,313
93266,549,1720,31.9,231,318
93267,1953,5811,33.6,726,1227
93268,4672,17124,27.3,2463,2209
93270,1629,5711,28.5,791,838
93271,402,2398,16.8,169,233
93272,1646,4548,36.2,767,879
93274,26090,78831,33.1,13084,13006
93276,41,150,27.3,11,30
93277,14121,54127,26.1,6499,7622
93280,7357,27356,26.9,3729,3628
93283,367,2416,15.2,86,281
93285,173,2465,7.0,113,60
93286,3467,10418,33.3,1972,1495
93287,21,119,17.6,6,15
93291,17992,61439,29.3,9682,8310
93292,12912,44759,28.8,6182,6730
93301,4356,13672,31.9,2364,1992
93304,14897,50158,29.7,7567,7330
93305,12173,36783,33.1,5931,6242
93306,22383,74769,29.9,10637,11746
93307,30300,89651,33.8,14736,15564
93308,13525,55150,24.5,7263,6262
93309,16431,62828,26.2,8220,8211
93311,14884,50535,29.5,6871,8013
93312,18330,59616,30.7,8842,9488
93313,18267,59924,30.5,7996,10271
93314,8928,34156,26.1,4808,4120
93401,4312,28773,15.0,1967,2345
93402,2773,15572,17.8,1502,1271
93405,1729,24991,6.9,892,837
93407,0,309,0.0,0,0
93408,1,11,9.1,1,0
93409,0,2591,0.0,0,0
93410,96,6523,1.5,36,60
93420,6840,32126,21.3,3970,2870
93422,6647,33781,19.7,3212,3435
93424,64,1174,5.5,31,33
93426,261,1566,16.7,132,129
93427,1275,5980,21.3,747,528
93428,828,6056,13.7,401,427
93429,0,64,0.0,0,0
93430,224,2941,7.6,32,192
93432,364,1434,25.4,199,165
93433,2744,12755,21.5,1219,1525
93434,2929,8272,35.4,1637,1292
93436,13957,55591,25.1,7040,6917
93437,1061,3681,28.8,596,465
93440,90,846,10.6,90,0
93441,147,1085,13.5,51,96
93442,1420,11399,12.5,732,688
93444,4623,22079,20.9,2073,2550
93445,1504,6912,21.8,619,885
93446,9962,45720,21.8,4870,5092
93449,952,8050,11.8,415,537
93450,269,830,32.4,162,107
93451,1086,4751,22.9,370,716
93452,89,307,29.0,24,65
93453,175,2096,8.3,102,73
93454,12092,41110,29.4,5421,6671
93455,10383,44186,23.5,4746,5637
93458,20127,59789,33.7,10246,9881
93460,1163,6280,18.5,661,502
93461,312,1369,22.8,162,150
93463,1310,8059,16.3,702,608
93465,2184,9829,22.2,1296,888
93501,1391,5404,25.7,706,685
93505,3467,14952,23.2,2003,1464
93510,1370,7397,18.5,753,617
93512,16,313,5.1,4,12
93513,299,1649,18.1,84,215
93514,2991,14692,20.4,1479,1512
93516,644,2583,24.9,283,361
93517,35,587,6.0,6,29
93518,102,894,11.4,57,45
93519,0,0,,0,0
93522,0,86,0.0,0,0
93523,1540,3867,39.8,555,985
93524,0,93,0.0,0,0
93526,215,855,25.1,84,131
93527,368,1734,21.2,205,163
93528,0,94,0.0,0,0
93529,17,302,5.6,0,17
93530,0,28,0.0,0,0
93531,43,425,10.1,0,43
93532,520,2768,18.8,194,326
93534,11883,42515,28.0,5449,6434
93535,24534,80905,30.3,11727,12807
93536,16992,72131,23.6,8448,8544
93541,298,817,36.5,102,196
93543,3559,12745,27.9,1876,1683
93544,178,1427,12.5,67,111
93545,391,1342,29.1,187,204
93546,1833,8689,21.1,733,1100
93549,0,254,0.0,0,0
93550,24358,81501,29.9,12173,12185
93551,13948,54478,25.6,6779,7169
93552,12668,43371,29.2,5470,7198
93553,96,1136,8.5,63,33
93554,0,65,0.0,0,0
93555,8700,33490,26.0,5110,3590
93558,0,17,0.0,0,0
93560,6279,21300,29.5,3042,3237
93561,7205,31060,23.2,3506,3699
93562,559,1867,29.9,192,367
93563,72,222,32.4,47,25
93581,0,3611,0.0,0,0
93591,2345,7340,31.9,1251,1094
93601,103,1206,8.5,66,37
93602,518,3038,17.1,264,254
93603,0,249,0.0,0,0
93604,49,366,13.4,27,22
93605,36,97,37.1,8,28
93606,406,1129,36.0,219,187
93608,289,1018,28.4,146,143
93609,1298,4889,26.5,479,819
93610,5470,23795,23.0,2489,2981
93611,12296,46620,26.4,6639,5657
93612,10081,37138,27.1,4493,5588
93614,2542,11760,21.6,1331,1211
93615,1932,5767,33.5,853,1079
93616,637,2163,29.4,256,381
93618,10842,32334,33.5,4789,6053
93619,15693,50848,30.9,7372,8321
93620,2189,9363,23.4,1378,811
93621,0,173,0.0,0,0
93622,3269,9419,34.7,1825,1444
93623,0,4,0.0,0,0
93624,249,892,27.9,121,128
93625,2501,8396,29.8,1281,1220
93626,651,2583,25.2,198,453
93627,110,196,56.1,110,0
93628,0,310,0.0,0,0
93630,6555,20272,32.3,3388,3167
93631,4209,16588,25.4,2195,2014
93633,0,26,0.0,0,0
93634,0,29,0.0,0,0
93635,16245,47683,34.1,8405,7840
93636,3435,13447,25.5,1457,1978
93637,12756,41324,30.9,6262,6494
93638,16330,51724,31.6,8064,8266
93640,5010,14162,35.4,2200,2810
93641,27,216,12.5,0,27
93643,422,3115,13.5,127,295
93644,1208,7169,16.9,702,506
93645,203,897,22.6,97,106
93646,3701,10157,36.4,1624,2077
93647,4003,11828,33.8,1895,2108
93648,4852,15370,31.6,2503,2349
93650,660,2844,23.2,321,339
93651,364,1580,23.0,146,218
93652,66,378,17.5,37,29
93653,254,1378,18.4,141,113
93654,8818,30476,28.9,4612,4206
93656,1624,6249,26.0,926,698
93657,10036,36053,27.8,5064,4972
93660,1444,3921,36.8,800,644
93662,7905,30191,26.2,3897,4008
93664,9,288,3.1,0,9
93665,40,386,10.4,40,0
93666,272,704,38.6,116,156
93667,328,1909,17.2,196,132
93668,271,1025,26.4,103,168
93669,54,324,16.7,33,21
93670,0,108,0.0,0,0
93673,74,378,19.6,36,38
93675,1587,4891,32.4,753,834
93701,2978,10602,28.1,1475,1503
93702,14483,45248,32.0,6919,7564
93703,9601,32603,29.4,4452,5149
93704,7670,29502,26.0,3985,3685
93705,11677,38777,30.1,5777,5900
93706,13081,41523,31.5,6100,6981
93710,6737,32730,20.6,3722,3015
93711,8590,39963,21.5,4244,4346
93720,10956,48597,22.5,5092,5864
93721,1068,8004,13.3,422,646
93722,24263,86387,28.1,11673,12590
93723,4094,13174,31.1,1910,2184
93725,8359,26568,31.5,3700,4659
93726,12099,44790,27.0,5449,6650
93727,25530,82176,31.1,12596,12934
93728,4444,17892,24.8,2168,2276
93730,3174,12461,25.5,1545,1629
93737,1923,6624,29.0,979,944
93740,22,1174,1.9,20,2
93741,2,77,2.6,0,2
93901,7467,29498,25.3,3515,3952
93905,21398,63121,33.9,9710,11688
93906,18816,66883,28.1,9070,9746
93907,6251,25124,24.9,3251,3000
93908,3412,12983,26.3,1838,1574
93920,409,1790,22.8,259,150
93921,259,2469,10.5,139,120
93923,2032,12630,16.1,1029,1003
93924,1140,6563,17.4,567,573
93925,467,1352,34.5,177,290
93926,2437,8941,27.3,1369,1068
93927,7254,19983,36.3,3908,3346
93928,28,1040,2.7,0,28
93930,5473,16807,32.6,2895,2578
93932,15,370,4.1,7,8
93933,6067,27197,22.3,2758,3309
93940,4598,31513,14.6,2357,2241
93943,0,12,0.0,0,0
93944,107,2605,4.1,0,107
93950,2585,15098,17.1,1565,1020
93953,482,3416,14.1,251,231
93954,189,501,37.7,110,79
93955,7241,32610,22.2,3332,3909
93960,6453,26037,24.8,2840,3613
93962,0,198,0.0,0,0
94002,6395,27893,22.9,2628,3767
94005,959,4756,20.2,497,462
94010,10367,43458,23.9,4488,5879
94014,6909,46331,14.9,3613,3296
94015,10292,65125,15.8,5535,4757
94018,589,3423,17.2,253,336
94019,2832,15275,18.5,1542,1290
94020,339,2030,16.7,188,151
94021,34,123,27.6,0,34
94022,4515,20052,22.5,2369,2146
94024,5901,24041,24.5,2649,3252
94025,9500,41017,23.2,4856,4644
94027,1419,7142,19.9,611,808
94028,1089,6888,15.8,605,484
94030,4319,22825,18.9,2056,2263
94037,154,2649,5.8,116,38
94038,776,3165,24.5,317,459
94040,7714,35667,21.6,3890,3824
94041,3258,15222,21.4,1513,1745
94043,6522,32670,20.0,3280,3242
94044,7338,38061,19.3,3646,3692
94060,145,1312,11.1,28,117
94061,8000,37539,21.3,3590,4410
94062,5722,26531,21.6,2777,2945
94063,7779,34807,22.3,4001,3778
94065,2697,11588,23.3,1456,1241
94066,8111,43369,18.7,3811,4300
94070,7328,31312,23.4,3531,3797
94074,48,151,31.8,0,48
94080,11389,66262,17.2,5477,5912
94085,3946,22996,17.2,1920,2026
94086,9214,49217,18.7,4560,4654
94087,14312,58913,24.3,6780,7532
94089,3322,23447,14.2,1502,1820
94102,3252,34077,9.5,1852,1400
94103,3031,32400,9.4,1061,1970
94104,52,557,9.3,29,23
94105,624,13722,4.5,166,458
94107,2854,30340,9.4,1654,1200
94108,1130,12070,9.4,554,576
94109,3574,56333,6.3,1764,1810
94110,10330,69679,14.8,4765,5565
94111,476,4468,10.7,139,337
94112,13781,80880,17.0,7190,6591
94114,3813,33858,11.3,1972,1841
94115,3558,33299,10.7,1515,2043
94116,7428,43903,16.9,3579,3849
94117,4162,39496,10.5,2168,1994
94118,5650,40108,14.1,2657,2993
94121,7048,43304,16.3,3669,3379
94122,8580,59453,14.4,4397,4183
94123,3251,24721,13.2,1707,1544
94124,8541,37347,22.9,3825,4716
94127,3704,21184,17.5,1827,1877
94128,0,0,,0,0
94129,1011,3952,25.6,430,581
94130,496,3136,15.8,134,362
94131,4678,28705,16.3,2380,2298
94132,3310,27641,12.0,1571,1739
94133,2667,25460,10.5,1212,1455
94134,6546,40738,16.1,3217,3329
94158,1855,10205,18.2,1127,728
94188,0,0,,0,0
94301,3314,17259,19.2,1732,1582
94303,11719,47989,24.4,5655,6064
94304,771,4489,17.2,456,315
94305,1117,17279,6.5,571,546
94306,6178,27785,22.2,3167,3011
94401,6636,35392,18.8,3115,3521
94402,5849,26150,22.4,3174,2675
94403,8526,43858,19.4,3912,4614
94404,7872,36397,21.6,3895,3977
94501,13453,63340,21.2,6505,6948
94502,3117,14225,21.9,1324,1793
94503,5524,21791,25.3,2833,2691
94505,3405,15445,22.0,1516,1889
94506,6616,26947,24.6,3475,3141
94507,3112,14503,21.5,1482,1630
94508,514,3406,15.1,230,284
94509,17605,70889,24.8,9697,7908
94510,5575,27223,20.5,2588,2987
94511,299,1993,15.0,124,175
94512,0,57,0.0,0,0
94513,17035,67580,25.2,8775,8260
94514,438,2023,21.7,148,290
94515,941,7024,13.4,419,522
94516,30,212,14.2,25,5
94517,2814,12349,22.8,1230,1584
94518,5712,28287,20.2,2795,2917
94519,4308,20162,21.4,2064,2244
94520,8224,36699,22.4,3993,4231
94521,7519,41092,18.3,3650,3869
94523,6870,34964,19.6,3132,3738
94525,498,3599,13.8,288,210
94526,8270,33396,24.8,3665,4605
94528,231,726,31.8,129,102
94530,4669,26483,17.6,2375,2294
94531,9739,44115,22.1,5062,4677
94533,19021,78129,24.3,9982,9039
94534,9441,41395,22.8,4465,4976
94535,1478,3873,38.2,688,790
94536,15836,71445,22.2,8044,7792
94538,13861,66215,20.9,7061,6800
94539,12828,53464,24.0,6387,6441
94541,14128,67401,21.0,6513,7615
94542,2550,16188,15.8,1134,1416
94544,16392,77712,21.1,7554,8838
94545,5773,33700,17.1,2470,3303
94546,9754,45761,21.3,4456,5298
94547,5152,26041,19.8,2595,2557
94548,238,598,39.8,136,102
94549,6808,28456,23.9,3440,3368
94550,10789,49463,21.8,5541,5248
94551,9346,40025,23.4,4870,4476
94552,3039,14948,20.3,1627,1412
94553,10043,49062,20.5,4537,5506
94555,10033,37671,26.6,5055,4978
94556,3516,15959,22.0,1686,1830
94558,12574,65084,19.3,6191,6383
94559,6332,28224,22.4,2924,3408
94560,9354,47470,19.7,4744,4610
94561,11230,44546,25.2,5246,5984
94562,0,0,,0,0
94563,4760,19416,24.5,2648,2112
94564,3340,18946,17.6,1659,1681
94565,23560,100826,23.4,10863,12697
94566,10362,45145,23.0,5206,5156
94567,201,719,28.0,142,59
94568,18519,71068,26.1,8920,9599
94569,0,251,0.0,0,0
94571,742,10514,7.1,367,375
94572,1927,9309,20.7,1106,821
94573,17,107,15.9,0,17
94574,1180,7827,15.1,558,622
94575,0,1048,0.0,0,0
94576,29,171,17.0,29,0
94577,8534,47937,17.8,3813,4721
94578,8513,42350,20.1,4763,3750
94579,3088,20272,15.2,1360,1728
94580,5395,29377,18.4,2814,2581
94582,13407,47338,28.3,7202,6205
94583,10185,39758,25.6,4482,5703
94585,7042,29401,24.0,2979,4063
94586,227,964,23.5,109,118
94587,12274,69502,17.7,5497,6777
94588,8388,35162,23.9,4221,4167
94589,6562,29959,21.9,3381,3181
94590,7220,37991,19.0,3666,3554
94591,11949,59026,20.2,5733,6216
94592,75,1020,7.4,31,44
94595,1849,17341,10.7,1036,813
94596,3772,23795,15.9,1937,1835
94597,3965,23654,16.8,1873,2092
94598,5048,26346,19.2,2317,2731
94599,181,3428,5.3,46,135
94601,11837,52102,22.7,5870,5967
94602,5620,31104,18.1,2585,3035
94603,9965,37042,26.9,4921,5044
94605,8747,44477,19.7,4348,4399
94606,6362,38459,16.5,3271,3091
94607,4085,27019,15.1,1721,2364
94608,4261,34083,12.5,1993,2268
94609,3691,25175,14.7,1982,1709
94610,5051,32404,15.6,2394,2657
94611,6934,39780,17.4,3550,3384
94612,1528,17742,8.6,910,618
94613,20,612,3.3,20,0
94618,3219,17285,18.6,1415,1804
94619,5986,27018,22.2,2916,3070
94621,9728,34911,27.9,4849,4879
94702,3434,17473,19.7,1847,1587
94703,2854,20404,14.0,1125,1729
94704,1166,25711,4.5,527,639
94705,2268,14508,15.6,1130,1138
94706,4991,20860,23.9,2433,2558
94707,2329,12596,18.5,1102,1227
94708,2044,11810,17.3,1119,925
94709,878,12200,7.2,358,520
94710,1273,8471,15.0,743,530
94720,253,5322,4.8,72,181
94801,8287,32759,25.3,4045,4242
94803,4757,27171,17.5,2394,2363
94804,10102,44387,22.8,4865,5237
94805,2738,14790,18.5,1236,1502
94806,14682,63730,23.0,6676,8006
94901,8336,40927,20.4,3919,4417
94903,5044,31582,16.0,2366,2678
94904,2725,13132,20.8,1361,1364
94920,2504,12906,19.4,1302,1202
94922,158,509,31.0,0,158
94923,129,1390,9.3,55,74
94924,101,1342,7.5,46,55
94925,2581,10155,25.4,1320,1261
94928,8906,46231,19.3,4743,4163
94929,104,442,23.5,68,36
94930,1584,8748,18.1,834,750
94931,1558,8945,17.4,829,729
94933,192,1284,15.0,147,45
94937,60,938,6.4,28,32
94938,34,428,7.9,21,13
94939,1479,7488,19.8,907,572
94940,41,260,15.8,10,31
94941,7637,32190,23.7,4041,3596
94945,3283,17309,19.0,1708,1575
94946,75,673,11.1,44,31
94947,4894,25183,19.4,2225,2669
94949,3736,18545,20.1,1619,2117
94950,0,23,0.0,0,0
94951,765,3574,21.4,383,382
94952,6815,33519,20.3,3339,3476
94954,7423,38201,19.4,3363,4060
94956,27,1189,2.3,20,7
94957,598,2081,28.7,259,339
94960,3896,16028,24.3,1737,2159
94963,93,462,20.1,26,67
94964,0,2054,0.0,0,0
94965,1547,12044,12.8,660,887
94970,7,400,1.8,7,0
94971,47,364,12.9,36,11
94972,70,153,45.8,0,70
94973,101,1438,7.0,34,67
95002,416,1920,21.7,142,274
95003,4407,24977,17.6,2236,2171
95004,589,3902,15.1,403,186
95005,1678,7552,22.2,904,774
95006,1141,8802,13.0,453,688
95007,42,359,11.7,22,20
95008,10718,48746,22.0,5266,5452
95010,1325,9243,14.3,495,830
95012,3921,10528,37.2,1914,2007
95013,0,53,0.0,0,0
95014,14762,61414,24.0,6902,7860
95017,201,907,22.2,101,100
95018,778,6055,12.8,388,390
95019,1843,5891,31.3,855,988
95020,18589,68365,27.2,8996,9593
95023,15165,57367,26.4,7496,7669
95030,2409,13373,18.0,1236,1173
95032,6759,27678,24.4,3145,3614
95033,1886,9853,19.1,987,899
95035,16409,79393,20.7,7409,9000
95037,13196,51867,25.4,7327,5869
95039,434,1427,30.4,155,279
95041,169,803,21.0,97,72
95043,147,669,22.0,84,63
95045,678,4063,16.7,224,454
95046,820,5801,14.1,451,369
95050,6855,39905,17.2,3016,3839
95051,11271,60499,18.6,5182,6089
95053,50,3317,1.5,30,20
95054,4856,24444,19.9,2499,2357
95060,6449,46527,13.9,2726,3723
95062,5568,36369,15.3,3144,2424
95064,343,9832,3.5,168,175
95065,1570,8125,19.3,902,668
95066,2590,15233,17.0,1122,1468
95070,6285,31688,19.8,2988,3297
95073,2462,11408,21.6,1090,1372
95075,115,566,20.3,81,34
95076,22182,83716,26.5,11198,10984
95110,4373,20314,21.5,2045,2328
95111,14902,59761,24.9,6979,7923
95112,8349,58775,14.2,4330,4019
95113,43,2161,2.0,43,0
95116,11719,50436,23.2,5203,6516
95117,6671,28663,23.3,3374,3297
95118,8002,32827,24.4,3948,4054
95119,2364,10461,22.6,1065,1299
95120,8766,38003,23.1,4337,4429
95121,6966,36657,19.0,2993,3973
95122,12664,52555,24.1,6518,6146
95123,15271,70952,21.5,7498,7773
95124,13157,51803,25.4,6496,6661
95125,11112,53333,20.8,5899,5213
95126,6346,36996,17.2,2989,3357
95127,13750,62269,22.1,6591,7159
95128,5961,33653,17.7,2676,3285
95129,8828,39797,22.2,4362,4466
95130,3282,13376,24.5,1707,1575
95131,6037,31335,19.3,2879,3158
95132,7111,40981,17.4,3301,3810
95133,5604,28749,19.5,2872,2732
95134,4384,30916,14.2,2421,1963
95135,4431,21402,20.7,1996,2435
95136,10186,47294,21.5,4913,5273
95138,4819,19420,24.8,2148,2671
95139,1989,7232,27.5,950,1039
95140,0,91,0.0,0,0
95148,9346,45688,20.5,4736,4610
95202,1447,6000,24.1,580,867
95203,4282,16237,26.4,2134,2148
95204,7005,30406,23.0,3444,3561
95205,12472,40128,31.1,6624,5848
95206,20409,68031,30.0,10501,9908
95207,13496,52877,25.5,7117,6379
95209,12433,46756,26.6,6164,6269
95210,12704,42654,29.8,6214,6490
95211,35,1676,2.1,20,15
95212,6669,27848,23.9,3388,3281
95215,6514,25647,25.4,3168,3346
95219,8124,30165,26.9,3810,4314
95220,2207,8244,26.8,1050,1157
95221,43,398,10.8,43,0
95222,928,5236,17.7,356,572
95223,222,2470,9.0,158,64
95224,76,311,24.4,37,39
95225,131,1019,12.9,90,41
95226,0,0,,0,0
95227,242,1180,20.5,80,162
95228,871,4648,18.7,445,426
95230,128,513,25.0,66,62
95231,840,4865,17.3,429,411
95232,0,202,0.0,0,0
95233,0,233,0.0,0,0
95236,1198,4518,26.5,658,540
95237,963,3992,24.1,362,601
95240,13417,50245,26.7,6151,7266
95242,6269,27433,22.9,2850,3419
95245,416,2813,14.8,126,290
95246,44,1548,2.8,44,0
95247,657,4022,16.3,268,389
95248,62,106,58.5,19,43
95249,913,4908,18.6,530,383
95251,0,521,0.0,0,0
95252,3001,14622,20.5,1557,1444
95253,229,504,45.4,111,118
95254,0,350,0.0,0,0
95255,321,1787,18.0,142,179
95257,0,398,0.0,0,0
95258,703,3885,18.1,452,251
95301,11626,41660,27.9,5071,6555
95303,177,891,19.9,85,92
95304,3362,15235,22.1,1657,1705
95305,0,158,0.0,0,0
95306,114,784,14.5,96,18
95307,13940,47978,29.1,6390,7550
95309,0,0,,0,0
95310,428,1849,23.1,246,182
95311,373,2182,17.1,119,254
95312,94,284,33.1,49,45
95313,126,860,14.7,70,56
95315,3913,13317,29.4,1688,2225
95316,1614,7154,22.6,1160,454
95317,319,948,33.6,174,145
95318,121,522,23.2,77,44
95319,265,1651,16.1,143,122
95320,3184,12385,25.7,1662,1522
95321,417,4068,10.3,243,174
95322,2496,9392,26.6,1019,1477
95323,388,1516,25.6,202,186
95324,2439,8763,27.8,896,1543
95325,0,44,0.0,0,0
95326,2668,10672,25.0,1311,1357
95327,1240,8788,14.1,676,564
95328,1405,3856,36.4,652,753
95329,331,2394,13.8,202,129
95330,8853,30051,29.5,4265,4588
95333,1096,3157,34.7,484,612
95334,5102,17302,29.5,2755,2347
95335,0,58,0.0,0,0
95336,11365,49145,23.1,5864,5501
95337,12260,44192,27.7,5227,7033
95338,2068,10102,20.5,1068,1000
95340,8606,36833,23.4,4393,4213
95341,12264,34541,35.5,6132,6132
95345,86,528,16.3,45,41
95346,180,1041,17.3,85,95
95348,9162,35853,25.6,4292,4870
95350,14150,55368,25.6,6984,7166
95351,14530,48134,30.2,7582,6948
95354,6677,25100,26.6,3253,3424
95355,14336,60338,23.8,6725,7611
95356,7940,33033,24.0,4298,3642
95357,4212,14403,29.2,1711,2501
95358,9795,31268,31.3,4314,5481
95360,3465,13781,25.1,2271,1194
95361,8779,35107,25.0,4172,4607
95363,8890,29784,29.8,4304,4586
95364,0,0,,0,0
95365,1144,3882,29.5,499,645
95366,4680,18500,25.3,1999,2681
95367,7525,25162,29.9,3624,3901
95368,3081,14849,20.7,1627,1454
95369,145,778,18.6,53,92
95370,5179,28548,18.1,2668,2511
95372,405,1639,24.7,178,227
95374,421,1581,26.6,220,201
95375,0,64,0.0,0,0
95376,14639,55038,26.6,6866,7773
95377,9314,35001,26.6,3985,5329
95379,799,3828,20.9,284,515
95380,12005,44204,27.2,6232,5773
95382,9660,38727,24.9,4440,5220
95383,461,3415,13.5,110,351
95385,137,531,25.8,59,78
95386,2864,10387,27.6,1258,1606
95387,483,1215,39.8,136,347
95388,4262,13518,31.5,1938,2324
95389,52,1963,2.6,52,0
95391,7362,23696,31.1,3540,3822
95401,7006,36905,19.0,3823,3183
95403,9968,44677,22.3,4761,5207
95404,7256,37437,19.4,3346,3910
95405,4297,23748,18.1,2030,2267
95407,10890,42138,25.8,5403,5487
95409,4192,26158,16.0,1720,2472
95410,34,797,4.3,34,0
95412,69,271,25.5,56,13
95415,413,1383,29.9,242,171
95417,82,211,38.9,82,0
95419,0,169,0.0,0,0
95420,100,351,28.5,99,1
95421,223,1679,13.3,128,95
95422,4438,16998,26.1,2235,2203
95423,507,3322,15.3,293,214
95425,2190,11331,19.3,1227,963
95426,211,1178,17.9,164,47
95427,55,589,9.3,32,23
95428,683,2775,24.6,281,402
95429,0,118,0.0,0,0
95430,0,0,,0,0
95431,4,76,5.3,2,2
95432,17,614,2.8,0,17
95435,144,347,41.5,0,144
95436,1275,6008,21.2,396,879
95437,2887,14865,19.4,1410,1477
95439,173,782,22.1,56,117
95441,243,1819,13.4,107,136
95442,237,2592,9.1,38,199
95443,113,190,59.5,36,77
95444,46,516,8.9,34,12
95445,339,2012,16.8,173,166
95446,368,4709,7.8,185,183
95448,2475,16745,14.8,1412,1063
95449,326,1785,18.3,155,171
95450,42,272,15.4,17,25
95451,2583,12957,19.9,1341,1242
95452,134,1240,10.8,84,50
95453,2186,11254,19.4,958,1228
95454,218,1714,12.7,85,133
95456,167,775,21.5,84,83
95457,615,3252,18.9,399,216
95458,520,3303,15.7,274,246
95459,188,853,22.0,62,126
95460,249,2349,10.6,98,151
95461,767,3909,19.6,390,377
95462,99,1091,9.1,65,34
95463,4,88,4.5,0,4
95464,594,2466,24.1,259,335
95465,173,1251,13.8,110,63
95466,115,880,13.1,10,105
95467,1357,5795,23.4,488,869
95468,362,1822,19.9,208,154
95469,223,1323,16.9,153,70
95470,1376,6068,22.7,586,790
95471,163,780,20.9,126,37
95472,4545,28443,16.0,2287,2258
95476,5861,36386,16.1,3068,2793
95480,3,6,50.0,2,1
95482,8413,34183,24.6,4458,3955
95485,476,2909,16.4,252,224
95486,0,27,0.0,0,0
95488,21,366,5.7,15,6
95490,2865,14360,20.0,1294,1571
95492,6477,28096,23.1,2909,3568
95493,0,144,0.0,0,0
95494,0,151,0.0,0,0
95497,72,1224,5.9,43,29
95501,4519,23706,19.1,1960,2559
95503,4418,24072,18.4,2166,2252
95511,0,102,0.0,0,0
95514,33,117,28.2,17,16
95519,4125,18781,22.0,1844,2281
95521,2924,21712,13.5,1743,1181
95524,335,1700,19.7,122,213
95525,148,1358,10.9,80,68
95526,133,638,20.8,94,39
95527,246,701,35.1,144,102
95528,323,1555,20.8,165,158
95531,5012,23029,21.8,2400,2612
95536,594,3258,18.2,245,349
95537,0,629,0.0,0,0
95538,119,1022,11.6,55,64
95540,3050,14415,21.2,1634,1416
95542,454,2862,15.9,205,249
95543,25,376,6.6,0,25
95545,54,492,11.0,12,42
95546,706,2666,26.5,378,328
95547,162,1121,14.5,86,76
95548,232,1034,22.4,98,134
95549,270,1140,23.7,156,114
95550,22,213,10.3,0,22
95551,255,1789,14.3,156,99
95552,8,423,1.9,8,0
95553,265,1037,25.6,142,123
95554,41,313,13.1,0,41
95555,60,370,16.2,31,29
95556,283,692,40.9,248,35
95558,27,246,11.0,17,10
95559,0,0,,0,0
95560,253,1337,18.9,206,47
95562,974,3396,28.7,306,668
95563,84,911,9.2,0,84
95564,96,564,17.0,52,44
95565,195,860,22.7,148,47
95567,410,2001,20.5,203,207
95568,19,224,8.5,15,4
95569,0,91,0.0,0,0
95570,478,2523,18.9,282,196
95571,0,30,0.0,0,0
95573,257,1417,18.1,72,185
95585,59,545,10.8,36,23
95587,0,0,,0,0
95589,210,1153,18.2,74,136
95595,24,143,16.8,7,17
95601,29,352,8.2,15,14
95602,2669,18610,14.3,1233,1436
95603,4935,28366,17.4,2637,2298
95604,0,34,0.0,0,0
95605,3461,14291,24.2,1694,1767
95606,10,185,5.4,3,7
95607,0,235,0.0,0,0
95608,12148,63715,19.1,6090,6058
95610,9428,46219,20.4,4805,4623
95612,306,1462,20.9,205,101
95613,0,0,,0,0
95614,857,4479,19.1,463,394
95615,214,1147,18.7,95,119
95616,5409,52090,10.4,2677,2732
95618,5101,26946,18.9,2559,2542
95619,1581,6414,24.6,665,916
95620,5713,22004,26.0,2694,3019
95621,8446,42089,20.1,4147,4299
95623,709,4488,15.8,241,468
95624,17597,67915,25.9,8238,9359
95625,0,88,0.0,0,0
95626,1117,5845,19.1,544,573
95627,1429,4137,34.5,697,732
95628,8601,44256,19.4,4239,4362
95629,61,747,8.2,28,33
95630,18900,76599,24.7,9751,9149
95631,1392,6244,22.3,490,902
95632,7230,31217,23.2,3399,3831
95633,791,3305,23.9,511,280
95634,509,3878,13.1,197,312
95635,71,948,7.5,37,34
95636,392,1374,28.5,179,213
95637,25,276,9.1,13,12
95638,325,2246,14.5,178,147
95639,46,314,14.6,26,20
95640,2058,12518,16.4,1163,895
95641,219,1517,14.4,96,123
95642,1062,7152,14.8,427,635
95645,283,1162,24.4,208,75
95646,85,249,34.1,29,56
95648,12647,55350,22.8,6137,6510
95650,2665,14098,18.9,903,1762
95651,166,738,22.5,121,45
95652,431,1193,36.1,194,237
95653,1,455,0.2,0,1
95655,1540,4954,31.1,904,636
95658,1070,5974,17.9,564,506
95659,201,790,25.4,138,63
95660,9888,35458,27.9,4491,5397
95661,6632,32827,20.2,3574,3058
95662,6883,32436,21.2,3376,3507
95663,430,2659,16.2,258,172
95664,166,1133,14.7,111,55
95665,828,4693,17.6,396,432
95666,686,5885,11.7,240,446
95667,6425,36084,17.8,3324,3101
95668,80,507,15.8,45,35
95669,367,2514,14.6,185,182
95670,14066,59449,23.7,7334,6732
95671,0,4478,0.0,0,0
95672,1034,5744,18.0,463,571
95673,3938,16665,23.6,2212,1726
95674,256,859,29.8,126,130
95675,108,487,22.2,28,80
95676,32,113,28.3,26,6
95677,6753,28591,23.6,3320,3433
95678,9489,45210,21.0,4626,4863
95679,27,131,20.6,0,27
95680,0,9,0.0,0,0
95681,452,1370,33.0,141,311
95682,5926,29750,19.9,2549,3377
95683,1191,6330,18.8,702,489
95684,190,2913,6.5,87,103
95685,764,4703,16.2,423,341
95686,319,1194,26.7,131,188
95687,14078,68996,20.4,6851,7227
95688,9919,40147,24.7,4739,5180
95689,272,1498,18.2,120,152
95690,407,1621,25.1,86,321
95691,10540,39961,26.4,4925,5615
95692,1282,4887,26.2,723,559
95693,1322,7624,17.3,513,809
95694,2193,9600,22.8,1149,1044
95695,9105,39892,22.8,4552,4553
95697,142,281,50.5,59,83
95698,29,196,14.8,14,15
95699,9,60,15.0,9,0
95701,74,1045,7.1,45,29
95703,109,1955,5.6,67,42
95709,1054,6103,17.3,612,442
95713,2042,10280,19.9,911,1131
95714,72,411,17.5,29,43
95715,26,110,23.6,11,15
95717,20,129,15.5,14,6
95720,36,107,33.6,20,16
95721,0,0,,0,0
95722,751,4829,15.6,396,355
95726,1392,7974,17.5,591,801
95728,120,549,21.9,87,33
95735,2,51,3.9,2,0
95736,0,131,0.0,0,0
95742,4228,14883,28.4,1766,2462
95746,5264,22743,23.1,2827,2437
95747,18839,75681,24.9,8717,10122
95757,14596,53232,27.4,7449,7147
95758,16573,66153,25.1,7833,8740
95762,11486,45842,25.1,5592,5894
95765,11470,43059,26.6,5566,5904
95776,6570,26352,24.9,3189,3381
95811,558,8456,6.6,293,265
95814,485,12248,4.0,235,250
95815,6669,26523,25.1,3128,3541
95816,1293,18334,7.1,660,633
95817,2204,14513,15.2,1065,1139
95818,4402,23062,19.1,1864,2538
95819,3368,19806,17.0,1524,1844
95820,7403,36024,20.6,3853,3550
95821,8265,37436,22.1,3764,4501
95822,10545,46413,22.7,5223,5322
95823,23542,82983,28.4,11455,12087
95824,8656,30556,28.3,4139,4517
95825,7896,37310,21.2,3514,4382
95826,8032,40205,20.0,4296,3736
95827,4839,21084,23.0,2608,2231
95828,14928,60850,24.5,7307,7621
95829,8263,31297,26.4,4142,4121
95830,124,746,16.6,23,101
95831,8743,44450,19.7,4214,4529
95832,3662,13116,27.9,1632,2030
95833,9396,40908,23.0,4753,4643
95834,8742,34892,25.1,4447,4295
95835,9839,40957,24.0,4460,5379
95837,16,306,5.2,13,3
95838,11497,41311,27.8,5538,5959
95841,4743,21542,22.0,2350,2393
95842,9755,34775,28.1,4597,5158
95843,12533,47195,26.6,5888,6645
95864,5846,25728,22.7,2891,2955
95901,9859,36119,27.3,4464,5395
95903,432,1868,23.1,223,209
95910,0,148,0.0,0,0
95912,1193,4908,24.3,550,643
95913,52,313,16.6,15,37
95914,72,450,16.0,23,49
95915,0,0,,0,0
95916,149,965,15.4,77,72
95917,1035,4091,25.3,555,480
95918,226,1807,12.5,139,87
95919,237,1183,20.0,174,63
95920,27,164,16.5,5,22
95922,86,593,14.5,48,38
95923,0,43,0.0,0,0
95925,48,188,25.5,48,0
95926,7415,42362,17.5,3722,3693
95928,5989,38412,15.6,2956,3033
95929,0,0,,0,0
95930,183,417,43.9,66,117
95932,2086,7789,26.8,1041,1045
95934,0,33,0.0,0,0
95935,43,465,9.2,0,43
95936,0,121,0.0,0,0
95937,218,1145,19.0,128,90
95938,957,4451,21.5,600,357
95939,37,376,9.8,15,22
95941,85,396,21.5,2,83
95942,391,1786,21.9,101,290
95943,139,670,20.7,74,65
95944,0,65,0.0,0,0
95945,5055,27388,18.5,2294,2761
95946,1327,9049,14.7,609,718
95947,306,1407,21.7,134,172
95948,3520,11456,30.7,1813,1707
95949,3101,21232,14.6,1569,1532
95950,99,442,22.4,35,64
95951,599,2522,23.8,328,271
95953,3175,11201,28.3,1622,1553
95954,2033,10163,20.0,1036,997
95955,354,1413,25.1,137,217
95956,99,458,21.6,69,30
95957,167,752,22.2,100,67
95958,0,0,,0,0
95959,2483,18244,13.6,1092,1391
95960,160,594,26.9,66,94
95961,9661,32663,29.6,4947,4714
95962,132,1136,11.6,21,111
95963,4389,16485,26.6,2219,2170
95965,4927,20835,23.6,2585,2342
95966,6423,30108,21.3,3136,3287
95968,208,1366,15.2,66,142
95969,1048,7564,13.9,369,679
95970,135,466,29.0,53,82
95971,983,5931,16.6,394,589
95972,86,142,60.6,47,39
95973,8474,38323,22.1,3760,4714
95974,0,65,0.0,0,0
95975,408,1628,25.1,226,182
95977,332,1822,18.2,149,183
95978,23,98,23.5,12,11
95979,35,374,9.4,9,26
95981,0,52,0.0,0,0
95982,729,3084,23.6,400,329
95983,10,395,2.5,0,10
95984,0,177,0.0,0,0
95986,0,104,0.0,0,0
95987,1916,6504,29.5,1016,900
95988,2486,8748,28.4,911,1575
95991,12091,43978,27.5,5897,6194
95993,8360,37222,22.5,3603,4757
96001,8049,34721,23.2,3472,4577
96002,8629,34634,24.9,4231,4398
96003,8476,43945,19.3,4290,4186
96006,56,587,9.5,40,16
96007,5081,24849,20.4,2549,2532
96008,205,1123,18.3,74,131
96009,59,247,23.9,31,28
96010,0,28,0.0,0,0
96011,70,232,30.2,29,41
96013,1177,4212,27.9,628,549
96014,40,173,23.1,29,11
96015,6,560,1.1,3,3
96016,57,319,17.9,0,57
96017,10,143,7.0,5,5
96019,2433,10466,23.2,1198,1235
96020,362,2593,14.0,107,255
96021,3780,15746,24.0,2154,1626
96022,2887,14751,19.6,1604,1283
96023,279,1189,23.5,117,162
96024,315,1105,28.5,113,202
96025,451,2247,20.1,251,200
96027,345,1907,18.1,167,178
96028,395,1805,21.9,190,205
96029,42,120,35.0,20,22
96031,3,66,4.5,3,0
96032,587,2606,22.5,269,318
96033,60,321,18.7,20,40
96034,54,345,15.7,21,33
96035,1219,4097,29.8,310,909
96037,0,131,0.0,0,0
96038,87,499,17.4,31,56
96039,112,726,15.4,57,55
96040,0,71,0.0,0,0
96041,389,3511,11.1,65,324
96044,309,1215,25.4,182,127
96046,0,328,0.0,0,0
96047,66,843,7.8,35,31
96048,143,1283,11.1,70,73
96050,9,400,2.3,3,6
96051,59,1067,5.5,45,14
96052,611,2538,24.1,359,252
96054,40,269,14.9,9,31
96055,918,3760,24.4,371,547
96056,267,1318,20.3,126,141
96057,148,1158,12.8,33,115
96058,190,809,23.5,94,96
96059,52,323,16.1,0,52
96061,0,0,,0,0
96062,95,1002,9.5,47,48
96063,0,77,0.0,0,0
96064,1011,4690,21.6,443,568
96065,29,364,8.0,17,12
96067,1226,7321,16.7,813,413
96068,23,125,18.4,15,8
96069,330,1390,23.7,141,189
96071,0,7,0.0,0,0
96073,1611,5648,28.5,825,786
96074,29,183,15.8,6,23
96075,0,341,0.0,0,0
96076,0,152,0.0,0,0
96078,37,135,27.4,37,0
96080,7782,31190,25.0,3818,3964
96084,99,664,14.9,61,38
96085,9,38,23.7,9,0
96086,42,268,15.7,21,21
96087,106,824,12.9,31,75
96088,488,4703,10.4,295,193
96090,79,421,18.8,30,49
96091,41,693,5.9,21,20
96092,83,402,20.6,51,32
96093,696,3959,17.6,463,233
96094,1222,6985,17.5,556,666
96096,78,784,9.9,47,31
96097,2494,10154,24.6,1013,1481
96101,927,4824,19.2,498,429
96103,214,1340,16.0,133,81
96104,240,962,24.9,145,95
96105,103,429,24.0,69,34
96106,155,465,33.3,92,63
96107,157,868,18.1,103,54
96108,51,149,34.2,26,25
96109,216,1297,16.7,47,169
96110,0,37,0.0,0,0
96111,0,23,0.0,0,0
96112,29,172,16.9,15,14
96113,163,2164,7.5,77,86
96114,401,2927,13.7,213,188
96115,17,122,13.9,12,5
96116,0,19,0.0,0,0
96117,127,288,44.1,83,44
96118,233,1581,14.7,72,161
96119,15,31,48.4,15,0
96120,245,1209,20.3,103,142
96121,0,145,0.0,0,0
96122,777,4121,18.9,364,413
96123,17,62,27.4,0,17
96124,122,320,38.1,77,45
96125,0,234,0.0,0,0
96126,41,227,18.1,41,0
96128,225,600,37.5,78,147
96129,217,640,33.9,0,217
96130,3690,21460,17.2,1871,1819
96132,0,17,0.0,0,0
96133,0,188,0.0,0,0
96134,535,2236,23.9,300,235
96135,0,106,0.0,0,0
96136,16,40,40.0,16,0
96137,455,2949,15.4,216,239
96140,190,1219,15.6,160,30
96141,67,592,11.3,41,26
96142,119,946,12.6,61,58
96143,675,3130,21.6,405,270
96145,597,3081,19.4,346,251
96146,97,1147,8.5,40,57
96148,69,630,11.0,26,43
96150,4779,29457,16.2,2537,2242
96155,0,0,,0,0
96161,4062,19146,21.2,2106,1956
97635,123,345,35.7,107,16
