ZIP Code,Population Under 18 years,Total Population,Percent Population Under 18 years,Female Population Under 18 years,Male Population Under 18 years,Population Density per sq mile
89010,71,461,15.4,36,35,
89019,146,2312,6.3,109,37,
89060,1917,12198,15.7,1343,574,23.789922435774773
89061,971,7529,12.9,308,663,86.46563705357839
89439,192,1639,11.7,69,123,76.5020601439026
90001,17012,57652,29.5,8721,8291,17979.87804878049
90002,15282,53108,28.8,7390,7892,17842.298696959573
90003,23588,75024,31.4,10560,13028,20446.068965517243
90004,10842,58833,18.4,4922,5920,20027.859718125204
90005,6565,37754,17.4,3074,3491,32953.38983050847
90006,11210,56628,19.8,6064,5146,30279.214064115826
90007,5377,41004,13.1,2723,2654,17440.329218106996
90008,5777,33076,17.5,3145,2632,11026.61596958175
90010,180,4185,4.3,115,65,10533.333333333332
90011,30173,106042,28.5,14284,15889,25821.86989974353
90012,3144,38430,8.2,1186,1958,10244.090159428257
90013,341,14587,2.3,183,158,18452.482269503547
90014,426,9273,4.6,139,287,30521.739130434784
90015,3477,25554,13.6,1750,1727,14116.952155936207
90016,9984,47309,21.1,4383,5601,12882.9580205727
90017,5743,28754,20.0,2583,3160,39366.33663366337
90018,10479,49898,21.0,4800,5679,17475.508163945353
90019,10146,59410,17.1,4981,5165,16227.331438904675
90020,6479,38400,16.9,3120,3359,35401.07913669064
90021,369,2781,13.3,172,197,1661.6084977238238
90022,15403,64147,24.0,7296,8107,14963.36499321574
90023,13155,44558,29.5,6235,6920,10775.306926106092
90024,3407,50392,6.8,1927,1480,17508.069939475452
90025,4744,44429,10.7,1909,2835,18595.84476675813
90026,9862,64769,15.2,4837,5025,16788.33746898263
90027,5519,45764,12.1,2645,2874,5661.046153846154
90028,2256,30982,7.3,1431,825,20771.01257445401
90029,5346,34649,15.4,2738,2608,26254.36046511628
90031,7147,37457,19.1,3516,3631,11284.857142857143
90032,8955,44881,20.0,3897,5058,9939.14849428868
90033,12086,47655,25.4,5959,6127,15164.784864205065
90034,7411,55061,13.5,3933,3478,18192.84101902612
90035,5421,26595,20.4,2723,2698,12181.45869947276
90036,5389,37713,14.3,2344,3045,15517.508143322477
90037,18249,69064,26.4,9249,9000,23329.98614958449
90038,3527,27979,12.6,1645,1882,18470.284237726097
90039,3674,28244,13.0,1701,1973,8232.417582417582
90040,2510,11839,21.2,1285,1225,2220.366379310345
90041,5107,28321,18.0,2274,2833,8316.082359488037
90042,10131,59151,17.1,5082,5049,13389.909271962822
90043,8905,44461,20.0,4374,4531,11301.316431009263
90044,29348,98990,29.6,13922,15426,19596.236769894156
90045,6206,41123,15.1,2968,3238,3698.763825634353
90046,3500,48170,7.3,1621,1879,8794.2110836569
90047,11834,52200,22.7,5327,6507,10847.036328871893
90048,1840,20411,9.0,754,1086,11498.151082937136
90049,6401,35819,17.9,3055,3346,2445.2310980496927
90052,0,0,,0,0,
90056,1711,8225,20.8,833,878,3568.6448184233836
90057,10044,47142,21.3,5146,4898,56557.954545454544
90058,731,3049,24.0,321,410,519.0114068441065
90059,12445,39471,31.5,6061,6384,13381.087919038584
90061,8031,28646,28.0,3934,4097,10598.9679321784
90062,7184,33528,21.4,3584,3600,18819.706498951786
90063,12316,52008,23.7,5877,6439,16391.476407914764
90064,4765,25956,18.4,2245,2520,6978.517722878625
90065,7936,44897,17.7,3840,4096,8631.876138433516
90066,8589,54142,15.9,4229,4360,12240.22462562396
90067,291,2653,11.0,155,136,5953.488372093023
90068,2216,21064,10.5,904,1312,2697.401299350325
90069,1233,20045,6.2,544,689,9309.944237918216
90071,0,313,0.0,0,0,1125.925925925926
90073,0,1014,0.0,0,0,1794.776119402985
90077,1839,7868,23.4,997,842,1146.7915174882953
90079,0,0,,0,0,0.0
90089,90,4164,2.2,68,22,11472.39263803681
90094,2470,11891,20.8,1596,874,12678.32167832168
90095,0,0,,0,0,0.0
90201,25850,95134,27.2,12706,13144,16785.571142284567
90210,3513,19180,18.3,1643,1870,1789.0770375883887
90211,1825,9208,19.8,1025,800,13158.57142857143
90212,1443,10881,13.3,762,681,12542.766631467794
90220,14012,49101,28.5,7169,6843,7378.143972246314
90221,14108,52119,27.1,6944,7164,9464.41181936443
90222,9080,33021,27.5,4644,4436,12762.09826376062
90230,6813,32005,21.3,3190,3623,7298.458149779735
90232,2926,16352,17.9,1328,1598,6898.28941285252
90240,6036,26026,23.2,3367,2669,8906.945829179129
90241,10175,45341,22.4,5079,5096,8767.480008201765
90242,9294,41685,22.3,4757,4537,9234.499557130204
90245,3550,17081,20.8,1860,1690,3099.289454001496
90247,9593,47682,20.1,4810,4783,12648.296059637913
90248,1670,11453,14.6,1022,648,2403.7450031559015
90249,5208,25929,20.1,2669,2539,8812.920592193808
90250,24046,96200,25.0,11494,12552,14053.63475177305
90254,3779,19551,19.3,1735,2044,13398.88033589923
90255,17925,71654,25.0,8383,9542,19965.11003757381
90260,7662,33282,23.0,3981,3681,13983.805668016194
90262,17157,66073,26.0,7974,9183,14536.67225481978
90263,14,1803,0.8,9,5,7747.863247863247
90265,3142,16652,18.9,1223,1919,162.39978380326096
90266,9408,35123,26.8,4715,4693,8662.05533596838
90270,6906,24950,27.7,3166,3740,22814.970563498737
90272,5562,21298,26.1,2867,2695,917.5591113350972
90274,5487,24942,22.0,2824,2663,2049.695147415017
90275,8779,41941,20.9,4192,4587,3083.875258646172
90277,6939,36339,19.1,3555,3384,9662.18487394958
90278,10659,42536,25.1,5405,5254,10920.730046308909
90280,22875,92262,24.8,11408,11467,12859.756097560976
90290,1053,5300,19.9,547,506,277.7036048064085
90291,3181,25656,12.4,1477,1704,11178.9046653144
90292,2988,24481,12.2,1432,1556,11417.461832061068
90293,1249,13039,9.6,481,768,4713.503649635036
90301,7690,37341,20.6,3896,3794,15848.4482063684
90302,6292,29307,21.5,3131,3161,15351.280710925248
90303,5733,23370,24.5,2688,3045,12344.667697063369
90304,6369,25725,24.8,2943,3426,16209.756097560976
90305,2380,14679,16.2,1263,1117,5881.025248661056
90401,315,7480,4.2,101,214,9376.15894039735
90402,2785,11816,23.6,1279,1506,5698.824681684623
90403,3179,24092,13.2,1501,1678,17251.4164305949
90404,3985,23975,16.6,1776,2209,11723.490613901571
90405,4012,26981,14.9,1681,2331,9891.765551959728
90501,9646,42536,22.7,4740,4906,7440.281442392261
90502,2926,18430,15.9,1506,1420,8274.676194729791
90503,8876,44280,20.0,3735,5141,8421.112587810898
90504,6639,32965,20.1,3231,3408,7415.646258503401
90505,8553,36214,23.6,4335,4218,6291.866028708134
90506,0,0,,0,0,0.0
90601,6056,30667,19.7,3175,2881,2888.417279758536
90602,6719,25949,25.9,3228,3491,6776.652452025587
90603,4471,20883,21.4,2099,2372,6569.712298450838
90604,9684,39795,24.3,4848,4836,9632.929436920886
90605,9459,41427,22.8,4465,4994,6445.662386470404
90606,6891,31717,21.7,3510,3381,8600.685292567212
90620,10230,47042,21.7,4823,5407,7259.422110552763
90621,8012,36151,22.2,4170,3842,8456.106870229007
90623,2991,15419,19.4,1356,1635,8613.009922822492
90630,11656,50170,23.2,6158,5498,8028.943089430893
90631,14887,69064,21.6,6753,8134,4919.355992844365
90638,9128,46170,19.8,4224,4904,6284.387096774193
90639,19,1833,1.0,19,0,
90640,13043,62294,20.9,6890,6153,7554.127117625856
90650,23294,101983,22.8,11267,12027,10555.847303575036
90660,12853,61561,20.9,6430,6423,8064.3787898335695
90670,3714,17556,21.2,1988,1726,1972.8300072132724
90680,6961,31102,22.4,3760,3201,12071.708463949844
90701,3208,16237,19.8,1669,1539,10135.135135135137
90703,9127,49334,18.5,3965,5162,5673.639689071788
90704,820,3822,21.5,432,388,55.21166002970206
90706,18465,78352,23.6,9624,8841,12504.340704340704
90710,6188,27517,22.5,3298,2890,12239.074550128536
90712,6917,31552,21.9,3207,3710,7300.830367734283
90713,5603,28439,19.7,2609,2994,8046.424452133795
90715,4157,20949,19.8,2136,2021,12097.345132743363
90716,3574,13941,25.6,1897,1677,15385.45059717698
90717,4361,21788,20.0,2087,2274,10443.83424862706
90720,5812,23673,24.6,2718,3094,3783.1880243461096
90723,14273,53286,26.8,6840,7433,11364.862018116706
90731,13715,63431,21.6,7065,6650,6592.195121951219
90732,3917,22078,17.7,1938,1979,6307.240704500979
90740,3293,24604,13.4,1615,1678,2186.138613861386
90742,27,469,5.8,12,15,3587.2093023255816
90743,53,434,12.2,28,25,2206.8965517241377
90744,15200,54277,28.0,6539,8661,6351.260126012601
90745,11794,58735,20.1,5723,6071,6755.044979333818
90746,4887,27643,17.7,2469,2418,4746.413137424373
90747,0,25,0.0,0,0,0.0
90755,2277,11764,19.4,1061,1216,5272.89461573861
90802,5186,40012,13.0,2661,2525,6024.457775726811
90803,3309,31659,10.5,1485,1824,7939.177542477222
90804,6574,37299,17.6,3044,3530,17670.680870773507
90805,24626,96515,25.5,12055,12571,12817.630408410838
90806,9445,40688,23.2,4104,5341,8446.899938612647
90807,6452,33153,19.5,3061,3391,7396.290432028953
90808,8805,39698,22.2,4062,4743,5766.161910308678
90810,8040,36306,22.1,3809,4231,5605.9030432787895
90813,13633,53647,25.4,6563,7070,18417.532467532463
90814,3814,20723,18.4,1944,1870,14039.00975243811
90815,8301,42759,19.4,3846,4455,5933.371136943578
90822,0,125,0.0,0,0,820.9876543209876
90831,0,0,,0,0,0.0
90840,0,0,,0,0,
91001,7394,36420,20.3,3863,3531,4442.73607748184
91006,6789,31986,21.2,3610,3179,5058.475894245724
91007,6498,33367,19.5,3447,3051,6144.777475022706
91008,90,744,12.1,46,44,560.5194805194805
91010,4747,26825,17.7,1973,2774,4123.153475353755
91011,5674,20389,27.8,2982,2692,1791.4927626320932
91016,9276,41822,22.2,4261,5015,4904.694503420618
91020,1843,7509,24.5,987,856,12235.376044568246
91024,2033,11151,18.2,1000,1033,3098.4263233190272
91030,6136,26583,23.1,2804,3332,7423.659673659674
91040,3853,20911,18.4,1771,2082,2476.6826923076924
91042,4455,27119,16.4,2355,2100,534.4993774850395
91046,0,141,0.0,0,0,38200.0
91101,2037,19737,10.3,966,1071,17259.84251968504
91103,5747,27167,21.2,2683,3064,5848.115057746785
91104,7013,35918,19.5,3242,3771,10019.62344205781
91105,1977,12692,15.6,890,1087,3014.2993326978076
91106,3751,23813,15.8,1935,1816,9276.775855723225
91107,5984,32581,18.4,2973,3011,3958.5008276188223
91108,2894,12559,23.0,1318,1576,3477.170757455793
91125,3,996,0.3,0,3,
91201,4162,22163,18.8,2308,1854,9561.89676877885
91202,3634,22831,15.9,1846,1788,4754.927860191018
91203,2735,16679,16.4,1225,1510,17988.610478359908
91204,3127,18445,17.0,1595,1532,18151.340996168583
91205,6245,35755,17.5,3419,2826,19814.775725593667
91206,5259,32294,16.3,2535,2724,5860.687022900763
91207,2130,11091,19.2,972,1158,7113.764927718416
91208,2828,15377,18.4,1641,1187,2049.2490867271003
91210,35,310,11.3,0,35,3705.2631578947367
91214,8071,32344,25.0,3734,4337,4351.195383347073
91301,5923,25244,23.5,2752,3171,785.7293837002145
91302,5706,26318,21.7,2928,2778,982.1857923497269
91303,6392,30611,20.9,3111,3281,14668.557919621748
91304,11244,54369,20.7,5613,5631,5516.507250848503
91306,10778,49460,21.8,5031,5747,12101.7316017316
91307,5395,25368,21.3,2912,2483,3168.7960687960685
91311,7921,40196,19.7,3937,3984,1249.4695633983802
91316,5371,28497,18.8,3033,2338,5573.025471870991
91320,10299,44138,23.3,5044,5255,2213.8679619349723
91321,8885,34305,25.9,5204,3681,1288.0720180045012
91324,5744,29744,19.3,2506,3238,7279.2390793799905
91325,6264,35537,17.6,3386,2878,7192.068106312293
91326,7655,36503,21.0,3721,3934,4460.0
91330,30,2699,1.1,19,11,6284.5691382765535
91331,24450,99804,24.5,11844,12606,11095.024077046548
91335,16435,77158,21.3,8066,8369,12326.682911970758
91340,8081,34822,23.2,3949,4132,10848.440687846109
91342,20896,92580,22.6,9523,11373,2077.94036747717
91343,15378,63193,24.3,7549,7829,11032.247172041196
91344,10828,53862,20.1,5138,5690,3851.057944959204
91345,3278,18481,17.7,1719,1559,5803.020961775585
91350,12160,42970,28.3,5952,6208,2433.5686373377034
91351,7827,32677,24.0,3457,4370,3539.7190881878887
91352,9628,45601,21.1,5064,4564,3923.535930440713
91354,8574,33039,26.0,4492,4082,4509.212501706019
91355,5668,30289,18.7,2630,3038,2232.8569256499923
91356,5851,30599,19.1,2755,3096,4186.553934269739
91360,7860,42444,18.5,3538,4322,2776.996680335872
91361,3432,18753,18.3,1421,2011,691.2044895555479
91362,7123,36770,19.4,3216,3907,1952.972773711096
91364,6567,28765,22.8,3306,3261,3766.4146438519697
91367,8049,44862,17.9,3671,4378,6020.301856551356
91371,0,0,,0,0,0.0
91377,3423,13627,25.1,1605,1818,2592.5857275254866
91381,5578,20864,26.7,3350,2228,497.63512659028254
91384,6449,27652,23.3,3121,3328,278.3081244389533
91387,12666,46812,27.1,5883,6783,770.2027292637727
91390,4368,18930,23.1,2377,1991,120.74700867673472
91401,7474,39179,19.1,3531,3943,11417.066968070076
91402,16688,67937,24.6,7788,8900,18975.30864197531
91403,4306,25887,16.6,1719,2587,7202.955115695567
91405,12361,55451,22.3,6146,6215,16721.8952324897
91406,12035,53276,22.6,5953,6082,6738.925424990694
91411,4664,23689,19.7,2186,2478,12752.561475409835
91423,4991,31787,15.7,2405,2586,8116.198916789758
91436,3479,16190,21.5,1644,1835,3205.707718827811
91501,3256,18951,17.2,1420,1836,7133.064516129031
91502,2067,12312,16.8,1059,1008,8352.94117647059
91504,5789,27479,21.1,2682,3107,3001.2874155133572
91505,6350,32156,19.7,3273,3077,5816.025401568921
91506,3387,19559,17.3,1553,1834,7372.678497730087
91601,4630,35615,13.0,2229,2401,13390.97459233978
91602,2432,19980,12.2,1072,1360,9970.098039215683
91604,5480,32073,17.1,2792,2688,7175.912254798566
91605,10529,51654,20.4,5109,5420,9747.672253258845
91606,8277,43552,19.0,3811,4466,13518.474016221087
91607,5192,30734,16.9,2737,2455,12581.678151601134
91608,0,56,0.0,0,0,30.456852791878173
91701,7922,39323,20.1,3656,4266,5405.032467532467
91702,12966,62196,20.8,6292,6674,945.1347029154878
91706,15377,72495,21.2,7647,7730,5660.088691796009
91708,4704,15908,29.6,2343,2361,604.4092147634382
91709,17346,78341,22.1,7731,9615,1847.636899183291
91710,17768,81466,21.8,8428,9340,4110.157172708276
91711,6245,37542,16.6,3222,3023,2424.812533476165
91722,7118,34470,20.6,3303,3815,8472.969696969696
91723,3651,17964,20.3,1752,1899,7571.367338191169
91724,5889,28575,20.6,2731,3158,4411.481719050674
91730,16581,71040,23.3,8538,8043,5451.453128414306
91731,6486,28201,23.0,2946,3540,7987.615283267457
91732,13197,58888,22.4,6696,6501,13452.643171806169
91733,9696,42953,22.6,4493,5203,6655.995257151327
91737,5043,23108,21.8,2179,2864,2384.9355797819626
91739,10068,41319,24.4,4321,5747,1384.666807402716
91740,6196,27131,22.8,3408,2788,5210.421241764823
91741,5693,26052,21.9,2816,2877,1279.935195640434
91744,17843,79380,22.5,8220,9623,9594.5697192821
91745,10417,55489,18.8,5499,4918,4277.528957528958
91746,6037,29429,20.5,3101,2936,5143.0538819073845
91748,7960,43851,18.2,3801,4159,3289.6444695259593
91750,6574,33436,19.7,3169,3405,1859.416302530075
91752,8960,37173,24.1,4756,4204,2392.7197984352206
91754,5908,33937,17.4,3017,2891,7376.769911504425
91755,4479,26418,17.0,2170,2309,8652.063492063493
91759,36,299,12.0,15,21,4.252947377349117
91761,14878,61837,24.1,7893,6985,2134.8799663063314
91762,16006,62990,25.4,7942,8064,4462.555066079295
91763,9570,37698,25.4,5068,4502,7463.584905660377
91764,13782,55311,24.9,7022,6760,7242.316934361957
91765,8805,45303,19.4,4474,4331,2490.7367514002585
91766,17123,69517,24.6,8697,8426,7049.81184392949
91767,12372,50715,24.4,6344,6028,8881.79419525066
91768,7804,35443,22.0,4187,3617,4345.609756097561
91770,11041,59410,18.6,4985,6056,9683.782955242184
91773,6833,34066,20.1,3513,3320,2250.4674145299145
91775,4697,24169,19.4,2168,2529,7911.261697321716
91776,6580,37340,17.6,2899,3681,11575.875486381325
91780,7577,35556,21.3,3878,3699,9064.759427828349
91784,5062,26116,19.4,2762,2300,2877.0240700218815
91786,12589,56025,22.5,6437,6152,6056.69238510567
91789,7779,41377,18.8,4124,3655,2743.4927837650466
91790,9802,44855,21.9,4683,5119,7748.610145934676
91791,6011,33902,17.7,2852,3159,5015.657934357121
91792,5781,31208,18.5,2948,2833,7757.938573659552
91801,8984,53320,16.8,4655,4329,12525.670675300647
91803,5619,29006,19.4,2739,2880,9230.981595092026
91901,3982,18669,21.3,2136,1846,229.80712432904437
91902,2860,17121,16.7,1428,1432,1583.3110457341534
91905,101,1411,7.2,54,47,19.921748806489823
91906,1370,4281,32.0,549,821,41.15269389890152
91910,16142,76313,21.2,8175,7967,5897.5927544291735
91911,21272,87799,24.2,10800,10472,6960.480829666876
91913,15361,56102,27.4,8099,7262,5612.796833773087
91914,4256,17373,24.5,1843,2413,2541.992775436484
91915,10966,35608,30.8,5110,5856,4397.852244792341
91916,338,1833,18.4,154,184,28.674819469798543
91917,351,851,41.2,226,125,20.21799942124047
91931,241,749,32.2,172,69,64.59475929311395
91932,5846,26157,22.3,2807,3039,6154.547580079495
91934,118,1251,9.4,37,81,15.252195538975672
91935,1869,9320,20.1,908,961,87.87562802161342
91941,6738,33602,20.1,3127,3611,4028.456767603064
91942,8475,40995,20.7,4185,4290,7056.152512998267
91945,6018,27541,21.9,2918,3100,6810.776625347838
91948,0,104,0.0,0,0,3.2965457933209117
91950,13018,57844,22.5,6416,6602,8557.039661987188
91962,417,2528,16.5,202,215,45.20660030001363
91963,156,624,25.0,79,77,11.6129657914515
91977,16264,65497,24.8,8064,8200,6379.007864488809
91978,2542,11006,23.1,1396,1146,917.001675041876
91980,17,103,16.5,0,17,0.0
92003,767,4404,17.4,381,386,341.1694192860948
92004,344,3200,10.8,168,176,2.4964940872220818
92007,3071,11939,25.7,1023,2048,5176.394293125811
92008,4453,27373,16.3,2023,2430,2607.34544755312
92009,12293,46334,26.5,6025,6268,3844.809191629052
92010,3682,16566,22.2,1529,2153,1891.3676042677016
92011,5682,24472,23.2,2730,2952,3800.367140890317
92014,2029,12532,16.2,748,1281,2082.9500396510707
92019,10482,45937,22.8,4877,5605,1399.168006050865
92020,14033,59775,23.5,7283,6750,5199.352284994602
92021,17270,69638,24.8,8576,8694,2538.7139341631296
92024,9894,50222,19.7,5159,4735,2829.070735090153
92025,12109,50270,24.1,6237,5872,2336.5663969963794
92026,11254,53053,21.2,4645,6609,1399.439791447113
92027,13069,55750,23.4,6554,6515,959.0407079052776
92028,12453,51135,24.4,6004,6449,417.5355328427131
92029,3898,19986,19.5,1987,1911,858.2003546099291
92036,281,3075,9.1,124,157,5.193254915646787
92037,6225,37665,16.5,2585,3640,3176.2410758758097
92040,10332,45906,22.5,5739,4593,675.5163997857015
92054,6901,37050,18.6,3325,3576,5449.665327978581
92055,0,10618,0.0,0,0,98.41252733039757
92056,11634,54190,21.5,5597,6037,4315.866439190836
92057,13080,58022,22.5,6634,6446,3955.4931836407377
92058,12414,48272,25.7,6314,6100,1062.251446131598
92059,477,1456,32.8,327,150,57.27975607100076
92060,0,506,0.0,0,0,6.636075857462318
92061,186,1677,11.1,120,66,65.29357692749628
92064,10841,48783,22.2,5138,5703,1175.5202305312137
92065,8103,36836,22.0,3546,4557,215.29504160048185
92066,42,319,13.2,27,15,15.866539734348793
92067,2250,9186,24.5,1415,835,400.4822935738847
92069,11473,46648,24.6,5492,5981,2601.1260285838025
92070,120,761,15.8,39,81,6.892554958853302
92071,13657,59795,22.8,6152,7505,3035.015120165526
92075,2372,12072,19.6,1233,1139,3712.990052662375
92078,13566,53019,25.6,6200,7366,3162.2754491017968
92081,6494,29475,22.0,3327,3167,3408.0627099664057
92082,4830,20678,23.4,2422,2408,156.17841689997456
92083,9225,37864,24.4,4677,4548,7079.3078586878155
92084,12046,49971,24.1,5346,6700,1774.9629525086443
92086,163,1409,11.6,111,52,5.687824711994579
92091,211,1288,16.4,109,102,1016.2790697674418
92092,0,521,0.0,0,0,
92093,0,2044,0.0,0,0,
92096,0,0,,0,0,
92101,2090,46025,4.5,966,1124,7879.45765230312
92102,8476,40051,21.2,4201,4275,9443.999109329772
92103,2979,34296,8.7,1502,1477,9293.351424694709
92104,6694,46613,14.4,3484,3210,12341.27198917456
92105,17282,72688,23.8,8380,8902,13201.876302988188
92106,3796,20483,18.5,2078,1718,3635.593220338983
92107,4158,29435,14.1,2142,2016,10471.891534391534
92108,2842,24201,11.7,1189,1653,4767.014519056261
92109,4528,44009,10.3,2118,2410,6147.5883821789985
92110,4526,30773,14.7,2225,2301,6000.99860195726
92111,8256,47710,17.3,4385,3871,5882.061563863664
92113,14147,50983,27.7,6889,7258,12908.667701174903
92114,14051,66487,21.1,6214,7837,8428.81274131274
92115,10454,61456,17.0,5116,5338,10334.738207164855
92116,3581,31836,11.2,1745,1836,9574.260355029586
92117,9556,54499,17.5,4277,5279,6739.170401011146
92118,3259,17602,18.5,1596,1663,3046.29388816645
92119,5004,24419,20.5,2616,2388,3795.125666412795
92120,6267,30241,20.7,2978,3289,3875.016273922666
92121,613,4150,14.8,336,277,372.27849110774383
92122,6054,45988,13.2,2734,3320,8895.872071402007
92123,5933,32951,18.0,2637,3296,3960.399489025665
92124,8543,31121,27.5,4352,4191,3347.710547833197
92126,15401,78111,19.7,7586,7815,7186.00034524426
92127,14428,51107,28.2,7039,7389,2209.226426744289
92128,9413,49273,19.1,4499,4914,4461.387322740475
92129,12267,52495,23.4,6155,6112,4326.505655762764
92130,15484,57363,27.0,7608,7876,3056.507218271924
92131,9365,35227,26.6,4472,4893,903.7083042206868
92132,0,0,,0,0,0.0
92134,0,241,0.0,0,0,3960.0
92135,0,1095,0.0,0,0,1513.0641330166272
92136,6,9630,0.1,0,6,
92139,7862,34930,22.5,4160,3702,10109.558412520964
92140,30,2807,1.1,0,30,6435.514018691589
92145,0,2810,0.0,0,0,183.04829919188123
92147,0,180,0.0,0,0,4551.724137931034
92154,19045,83758,22.7,8979,10066,1745.122022249403
92155,0,196,0.0,0,0,1178.117048346056
92161,0,12,0.0,0,0,
92173,7195,28609,25.1,3591,3604,10861.31386861314
92179,0,3031,0.0,0,0,
92182,0,0,,0,0,
92201,13834,64325,21.5,6919,6915,4007.093073459569
92203,8130,33558,24.2,4062,4068,1753.16935746018
92210,286,4832,5.9,83,203,358.75410294014944
92211,3129,26741,11.7,1700,1429,1722.0910623946038
92220,7503,32797,22.9,3342,4161,236.02994240756203
92222,0,0,,0,0,0.0
92223,17554,61686,28.5,8262,9292,1265.4499377556465
92225,4610,21189,21.8,2234,2376,38.762692113719964
92227,8222,27540,29.9,4101,4121,45.75805250763897
92230,343,2039,16.8,176,167,202.3636207930119
92231,11135,38674,28.8,5300,5835,581.8065118450227
92233,1109,6871,16.1,575,534,49.45676479099256
92234,10485,51964,20.2,5547,4938,3712.544026009212
92236,9415,42506,22.1,4284,5131,743.318620555852
92239,16,296,5.4,5,11,0.5705786441117251
92240,10575,40755,25.9,5238,5337,1013.8297872340426
92241,1251,8232,15.2,785,466,58.03386251366945
92242,176,1230,14.3,47,129,28.74897719984962
92243,14520,49193,29.5,7061,7459,442.2401468485801
92249,2269,7910,28.7,1031,1238,425.8886315577485
92250,2161,8033,26.9,1083,1078,23.426680591186688
92251,7975,27050,29.5,4071,3904,98.31989845006991
92252,1384,7911,17.5,901,483,84.57977207977208
92253,6932,37898,18.3,2569,4363,1027.661047115242
92254,1728,9362,18.5,947,781,173.8840216937839
92256,633,3387,18.7,284,349,50.134175217048146
92257,389,1186,32.8,228,161,4.496233434686391
92258,107,547,19.6,55,52,49.78813559322034
92259,0,225,0.0,0,0,0.3091372638920728
92260,4186,31039,13.5,2224,1962,1101.852737651073
92262,2941,25856,11.4,1190,1751,808.630927014972
92264,1186,20229,5.9,501,685,409.8573026871062
92266,0,170,0.0,0,0,0.1004261783197603
92267,0,0,,0,0,0.6131930850687484
92268,0,405,0.0,0,0,5.166252888078871
92270,1493,17257,8.7,646,847,724.0449964846496
92273,447,1631,27.4,233,214,574.8521630874571
92274,3027,15917,19.0,1603,1424,65.2504776399728
92275,363,1406,25.8,161,202,62.42600631412787
92276,2257,8242,27.4,1342,915,220.43882403804585
92277,8194,27370,29.9,3848,4346,15.29865330077325
92278,0,3574,0.0,0,0,12757.65306122449
92280,0,0,,0,0,0.0
92281,831,2238,37.1,393,438,217.12769988632056
92282,255,1361,18.7,139,116,19.094091439482337
92283,662,1967,33.7,332,330,5.209368431829542
92284,5949,25741,23.1,3010,2939,202.3188496748433
92285,216,2726,7.9,108,108,8.965050997913053
92301,12849,38565,33.3,6064,6785,154.7759394616141
92304,0,0,,0,0,0.1468336374887252
92305,202,500,40.4,112,90,5.288403471539245
92307,10693,40534,26.4,4817,5876,207.24238738450376
92308,13210,43191,30.6,6525,6685,410.46330288559335
92309,159,561,28.3,82,77,1.7685093753312466
92310,2671,8967,29.8,1301,1370,115.74034892577772
92311,10378,34226,30.3,4988,5390,76.8549301051074
92313,2803,13104,21.4,1337,1466,3474.1355463347163
92314,2385,10658,22.4,1079,1306,291.84877622377627
92315,1134,5228,21.7,509,625,180.669980254647
92316,7968,30656,26.0,3045,4923,2535.279805352798
92317,46,567,8.1,10,36,
92320,2251,10366,21.7,960,1291,646.5529597248101
92321,158,784,20.2,107,51,127.28038170081392
92322,89,746,11.9,30,59,169.65643052599577
92324,14007,57593,24.3,7185,6822,2146.359022353407
92325,1630,8449,19.3,831,799,989.4724796887516
92327,86,633,13.6,26,60,34.06772745818033
92328,56,1022,5.5,0,56,0.3258989284804088
92332,21,177,11.9,21,0,0.0998937300743889
92333,34,429,7.9,6,28,40.55930186433955
92335,27803,96704,28.8,13127,14676,5684.940138626339
92336,27833,100571,27.7,13447,14386,4965.598752703315
92337,9497,37292,25.5,4748,4749,2890.5109489051097
92338,0,0,,0,0,0.0
92339,313,1064,29.4,47,266,17.50696731694958
92341,56,331,16.9,36,20,24.8074422326698
92342,1409,6317,22.3,693,716,68.45689505990615
92344,5136,20448,25.1,2227,2909,596.0960561657314
92345,25665,87476,29.3,12748,12917,846.9996762968359
92346,15638,60025,26.1,7233,8405,2337.7461464709786
92347,105,601,17.5,23,82,3.979212547045595
92350,0,468,0.0,0,0,
92352,1220,6147,19.8,526,694,547.9060088441863
92354,4349,23054,18.9,2306,2043,4616.666666666666
92356,1719,7048,24.4,794,925,16.956848799835875
92358,49,762,6.4,7,42,9.68753886762206
92359,2414,9758,24.7,997,1417,509.4555873925501
92363,1127,5447,20.7,583,544,14.445382262339324
92364,0,12,0.0,0,0,0.0095268581184074
92365,469,2393,19.6,162,307,5.228376823828322
92368,276,1018,27.1,156,120,21.30101270410115
92369,34,3999,0.9,0,34,
92371,6472,21265,30.4,3542,2930,158.08161102278748
92372,1378,5208,26.5,756,622,225.332400279916
92373,7473,33946,22.0,3740,3733,813.3667711598746
92374,10488,44976,23.3,4848,5640,2458.688506323472
92376,23625,85727,27.6,11829,11796,6508.480936655659
92377,5336,20935,25.5,2666,2670,2863.9332870048643
92378,110,437,25.2,65,45,203.24189526184537
92382,1277,4884,26.1,611,666,235.85875899897155
92384,0,23,0.0,0,0,0.0776307107091565
92385,0,167,0.0,0,0,25.52128583840139
92386,426,2064,20.6,317,109,887.2442316064431
92389,0,187,0.0,0,0,4.743790557171627
92391,411,2177,18.9,197,214,1143.5068216270845
92392,18638,61859,30.1,9303,9335,1526.8563460352366
92394,11843,39939,29.7,5689,6154,1087.299853303786
92395,14226,48479,29.3,6739,7487,2705.109229767332
92397,908,5059,17.9,384,524,97.44721084147494
92398,166,1394,11.9,60,106,16.3990058788889
92399,13997,55236,25.3,7389,6608,1026.525248382948
92401,546,2060,26.5,275,271,2898.529411764706
92404,18370,64090,28.7,8728,9642,2002.8811144530632
92405,10154,31550,32.2,4877,5277,6144.111776447106
92407,18872,67207,28.1,9904,8968,831.0393808777429
92408,3016,12478,24.2,1553,1463,1366.0398969170565
92410,14139,48398,29.2,6834,7305,5426.229508196721
92411,8019,26915,29.8,4026,3993,5602.763018065887
92415,0,0,,0,0,
92501,5060,22136,22.9,2164,2896,3905.244444444445
92503,23332,88617,26.3,11648,11684,2710.643629264882
92504,12640,57636,21.9,5646,6994,2752.2155107799476
92505,13037,52696,24.7,6650,6387,5375.982704402516
92506,10843,44344,24.5,4853,5990,2819.5335636722607
92507,11579,60949,19.0,5238,6341,2788.6045750105254
92508,9544,36500,26.1,5028,4516,3511.852662290299
92509,21134,80325,26.3,10463,10671,2681.3684004947595
92518,314,1132,27.7,128,186,160.92538451760518
92521,0,0,,0,0,
92530,16215,58249,27.8,8493,7722,732.1762141967622
92532,7837,27454,28.5,2792,5045,1662.0522241175695
92536,439,2569,17.1,287,152,24.55340528470413
92539,790,3760,21.0,352,438,34.033242485893055
92543,9627,38403,25.1,4601,5026,1959.6487560108717
92544,13920,51567,27.0,7076,6844,295.0126746793277
92545,10196,45219,22.5,4865,5331,1488.4361973914213
92548,1968,7110,27.7,989,979,650.5470961818042
92549,506,3535,14.3,208,298,28.171935547740492
92551,9692,36326,26.7,4495,5197,5598.34200260078
92553,21327,73945,28.8,11091,10236,7224.312731526614
92555,11273,44923,25.1,5528,5745,708.0773675567181
92557,14335,54936,26.1,7197,7138,3054.476897968372
92561,245,1622,15.1,118,127,8.980738117769164
92562,17231,64155,26.9,8299,8932,590.5239212985201
92563,21431,78139,27.4,11100,10331,3154.9781254142913
92567,3290,10721,30.7,1820,1470,302.19431951948326
92570,16063,58275,27.6,8080,7983,568.0438853185543
92571,18283,59896,30.5,9361,8922,1519.2666649620292
92582,7192,21961,32.7,3316,3876,990.767392603052
92583,9066,33781,26.8,4587,4479,1100.8648500240236
92584,15518,54663,28.4,8070,7448,1859.562334673125
92585,7705,27083,28.4,3268,4437,1395.2998947737635
92586,2809,20152,13.9,1244,1565,2886.494030082183
92587,5139,18926,27.2,2229,2910,2521.976483762598
92590,1108,5212,21.3,535,573,95.91863010171237
92591,10048,41047,24.5,4742,5306,2414.5378541569903
92592,23491,81636,28.8,11834,11657,781.8330382677381
92595,8130,34698,23.4,3778,4352,1578.2786125023188
92596,11615,35726,32.5,5651,5964,599.7100098389519
92602,7086,26663,26.6,3867,3219,1434.1695902561728
92603,3706,19329,19.2,1860,1846,2020.927205366977
92604,5971,29080,20.5,2998,2973,8461.768219832737
92606,5293,24431,21.7,2784,2509,7921.9653179190755
92610,2609,13107,19.9,1316,1293,4207.374412274189
92612,4112,34868,11.8,2167,1945,5014.698983580923
92614,6884,29544,23.3,3055,3829,6202.528787536689
92617,2194,20432,10.7,1141,1053,7705.013428827216
92618,14473,59386,24.4,6225,8248,2634.3031123139376
92620,16595,61110,27.2,7989,8606,8182.741116751269
92624,1254,6881,18.2,813,441,4242.182302062542
92625,2250,12546,17.9,1231,1019,5140.34401876466
92626,8713,50198,17.4,4446,4267,5253.297609233306
92627,12731,62181,20.5,6388,6343,9758.830884651454
92629,4644,26144,17.8,1838,2806,5341.569480134413
92630,13406,66240,20.2,6149,7257,5769.975327386601
92637,51,17452,0.3,16,35,5407.757166947724
92646,10328,56033,18.4,4883,5445,7026.20792448143
92647,11319,60114,18.8,5619,5700,8157.643312101911
92648,8099,45667,17.7,3729,4370,5642.0214090117
92649,5519,35206,15.7,2488,3031,6356.319801453643
92651,3658,23981,15.3,1785,1873,1076.0371797778282
92653,5766,29923,19.3,2712,3054,4342.428179587123
92655,1718,8040,21.4,775,943,9667.774086378737
92656,12893,53143,24.3,6648,6245,6494.123530882721
92657,2182,9169,23.8,1101,1081,1083.0220508495
92660,7149,35926,19.9,3457,3692,3683.066361556064
92661,351,3300,10.6,105,246,5893.682588597842
92662,184,2346,7.8,77,107,13028.846153846154
92663,2181,21886,10.0,881,1300,6903.980553023397
92672,6889,38020,18.1,3414,3475,974.5803222450298
92673,8487,30633,27.7,3496,4991,2972.7316836487144
92675,8112,35099,23.1,4358,3754,2975.2726729418796
92676,461,1952,23.6,287,174,29.273701186499252
92677,10919,64259,17.0,5032,5887,3983.21780372127
92678,95,630,15.1,45,50,14.54936297383736
92679,6635,30971,21.4,3462,3173,1302.2442899702085
92683,19219,90630,21.2,10180,9039,9343.997531118195
92688,10750,44444,24.2,5185,5565,3372.6172465960663
92691,9773,48073,20.3,4827,4946,5700.467129998861
92692,8830,45977,19.2,4451,4379,5532.697230626019
92694,11862,35074,33.8,5920,5942,664.400448262981
92697,0,0,,0,0,
92701,13624,49462,27.5,5922,7702,16991.007751937985
92703,14234,61593,23.1,6541,7693,15659.59453088166
92704,18619,80767,23.1,9443,9176,11601.863102470636
92705,11274,46854,24.1,5607,5667,3991.515357203462
92706,8416,36548,23.0,3938,4478,11039.54802259887
92707,13834,59712,23.2,7074,6760,11999.617224880383
92708,10939,56754,19.3,5080,5859,6241.595253790376
92780,13422,54945,24.4,6114,7308,9348.74083519286
92782,6769,29838,22.7,2827,3942,4480.851063829788
92801,14850,64022,23.2,7115,7735,10452.551263710062
92802,11510,44316,26.0,5202,6308,9666.813090270152
92804,18664,84700,22.0,9704,8960,12375.157894736842
92805,17636,73310,24.1,9469,8167,11977.0281124498
92806,9431,40945,23.0,4435,4996,5234.413640505011
92807,7287,36117,20.2,3522,3765,3292.8767123287676
92808,4320,21080,20.5,2012,2308,4357.4
92821,9078,41604,21.8,4742,4336,2769.208999575492
92823,1352,5495,24.6,765,587,670.0643776824033
92831,6638,36470,18.2,2766,3872,6086.905362245756
92832,6686,26040,25.7,3617,3069,8941.968911917098
92833,12433,52799,23.5,6047,6386,6851.460615545123
92835,6079,26687,22.8,3657,2422,4564.761405348715
92840,11540,53826,21.4,5798,5742,10536.372453928225
92841,7301,34188,21.4,3588,3713,7453.947368421053
92843,10572,47549,22.2,5220,5352,12076.515151515152
92844,4169,22622,18.4,2139,2030,10808.00381133873
92845,3086,15530,19.9,1271,1815,6952.4236983842
92860,4588,25367,18.1,2104,2484,1926.7360373752388
92861,1228,5814,21.1,565,663,2814.921090387374
92865,4619,21140,21.8,2047,2572,5485.2441890833115
92866,2649,14873,17.8,1088,1561,8094.438614900315
92867,9521,44216,21.5,4431,5090,3702.1577938848623
92868,5040,27280,18.5,2582,2458,7719.97673742367
92869,7669,36429,21.1,3742,3927,2691.434085510689
92870,12575,53150,23.7,6223,6352,7905.186506167335
92879,11673,49111,23.8,5485,6188,5035.2091177368475
92880,21465,74645,28.8,10307,11158,2774.067848410758
92881,7429,31401,23.7,3154,4275,1007.3950822702902
92882,17363,69472,25.0,8744,8619,6362.645781901762
92883,9341,37211,25.1,4990,4351,648.5145883895198
92886,12023,50437,23.8,5902,6121,3958.0376427028696
92887,4042,20353,19.9,1935,2107,1715.728843597696
93001,6034,31751,19.0,3376,2658,328.54598546192557
93003,11314,53283,21.2,5667,5647,2475.872023093577
93004,6234,31151,20.0,2915,3319,4450.561957604211
93010,10258,47656,21.5,4577,5681,2113.3260513380665
93012,6459,36145,17.9,3069,3390,712.5533527464199
93013,3228,16459,19.6,1552,1676,411.3240376017979
93015,4682,18716,25.0,2611,2071,195.95206276673707
93021,8813,37980,23.2,4495,4318,800.0460337720492
93022,1271,6422,19.8,646,625,2104.8104491876397
93023,3297,21279,15.5,1535,1762,78.73180748534857
93030,14918,58511,25.5,7027,7891,4240.345780486076
93033,24204,82517,29.3,12216,11988,2637.117564839261
93035,5264,26286,20.0,2612,2652,5652.415987273812
93036,11750,46959,25.0,5837,5913,2647.6768357772908
93040,484,1838,26.3,286,198,4.896283178230619
93041,5704,23108,24.7,2934,2770,4099.676815784997
93042,0,107,0.0,0,0,4.501397611355139
93043,0,722,0.0,0,0,165.65656565656565
93060,9194,34337,26.8,4777,4417,365.60407584886474
93063,10848,57075,19.0,5430,5418,1555.5340503774155
93064,0,0,,0,0,0.0
93065,15311,72086,21.2,7439,7872,2412.791087846453
93066,436,2805,15.5,202,234,69.50550103367155
93067,235,999,23.5,104,131,635.1118760757315
93101,5547,29870,18.6,2392,3155,10196.752029981262
93103,3447,19653,17.5,1861,1586,3738.987986894794
93105,4268,26482,16.1,1770,2498,192.69789937610895
93106,88,5369,1.6,45,43,
93108,1473,11209,13.1,800,673,375.1929635612995
93109,1542,11626,13.3,830,712,3297.9842243645926
93110,2899,16403,17.7,1282,1617,1951.6328550222663
93111,3802,18165,20.9,1989,1813,2270.1905347264906
93117,7380,53345,13.8,3454,3926,352.79838647302756
93201,478,1209,39.5,306,172,17.43869969471821
93202,1489,4308,34.6,614,875,2756.0182173064413
93203,7485,20781,36.0,3718,3767,131.06158371408972
93204,3781,13423,28.2,1947,1834,184.5615724481704
93205,535,2320,23.1,165,370,93.24772697892875
93206,616,1709,36.0,306,310,10.62557216966738
93207,52,232,22.4,21,31,4.122845526903476
93208,0,127,0.0,0,0,14.276443867618427
93210,4596,18937,24.3,2517,2079,23.651720388920488
93212,5026,23391,21.5,2686,2340,190.63206560253772
93215,13257,53334,24.9,5511,7746,382.5314663202106
93218,309,796,38.8,186,123,12.597489641725568
93219,3093,9871,31.3,1542,1551,106.85450570803984
93220,0,0,,0,0,1.639881928501148
93221,3982,14423,27.6,1990,1992,110.5213341914966
93222,296,2036,14.5,63,233,16.698921758363284
93223,2994,10424,28.7,1533,1461,3494.0380277151144
93224,152,501,30.3,85,67,10.226442658875092
93225,839,5018,16.7,357,482,49.42612855434375
93226,0,55,0.0,0,0,1.0795865973273648
93227,44,227,19.4,0,44,
93230,19377,68572,28.3,9622,9755,266.9735684697148
93234,2275,6571,34.6,1249,1026,53.781686957681565
93235,1346,4360,30.9,633,713,1099.301036394312
93237,2,98,2.0,1,1,
93238,220,866,25.4,76,144,7.389432199678879
93239,331,1404,23.6,173,158,30.68170098662725
93240,1385,5470,25.3,596,789,105.19050248481504
93241,5384,15978,33.7,2560,2824,3365.2931854199683
93242,858,2683,32.0,382,476,84.86441344075456
93243,126,977,12.9,56,70,9.25908926790162
93244,16,121,13.2,6,10,41.5233728187492
93245,10168,37439,27.2,4811,5357,321.9308279783333
93246,0,1129,0.0,0,0,
93247,5518,17827,31.0,2619,2899,263.48670710018695
93249,749,1996,37.5,327,422,9.638613496026965
93250,5203,15126,34.4,2594,2609,163.9873177484538
93251,80,293,27.3,37,43,2.2115842221662327
93252,424,1680,25.2,242,182,7.121390597077095
93254,192,869,22.1,133,59,3.767668723870197
93255,0,872,0.0,0,0,3.588883705879634
93256,1776,5575,31.9,766,1010,77.86308638501427
93257,23865,79217,30.1,11417,12448,199.23140066143887
93258,206,1086,19.0,113,93,1401.025641025641
93260,40,178,22.5,12,28,6.554734721289456
93261,591,1889,31.3,324,267,377.3160173160173
93262,0,18,0.0,0,0,0.1714716843091977
93263,7631,22952,33.2,4137,3494,236.90743330406409
93265,622,3194,19.5,309,313,8.288894933765826
93266,549,1720,31.9,231,318,18.309954140814675
93267,1953,5811,33.6,726,1227,102.4673157613362
93268,4672,17124,27.3,2463,2209,269.95008807985903
93270,1629,5711,28.5,791,838,82.12230855922651
93271,402,2398,16.8,169,233,17.70834700224389
93272,1646,4548,36.2,767,879,58.64770886920073
93274,26090,78831,33.1,13084,13006,342.39945995502666
93276,41,150,27.3,11,30,31.41852286049238
93277,14121,54127,26.1,6499,7622,1347.1137262858883
93280,7357,27356,26.9,3729,3628,89.86040211533046
93283,367,2416,15.2,86,281,8.486812122047711
93285,173,2465,7.0,113,60,36.93150483473657
93286,3467,10418,33.3,1972,1495,144.18957084797137
93287,21,119,17.6,6,15,1.0447719611066224
93291,17992,61439,29.3,9682,8310,693.5401498865755
93292,12912,44759,28.8,6182,6730,372.7308379450085
93301,4356,13672,31.9,2364,1992,2946.091015169194
93304,14897,50158,29.7,7567,7330,6278.030505753278
93305,12173,36783,33.1,5931,6242,6685.447632215693
93306,22383,74769,29.9,10637,11746,763.2392673330388
93307,30300,89651,33.8,14736,15564,610.9380089792796
93308,13525,55150,24.5,7263,6262,160.21810858418047
93309,16431,62828,26.2,8220,8211,5617.011098354382
93311,14884,50535,29.5,6871,8013,218.9522530223471
93312,18330,59616,30.7,8842,9488,4177.2509173017215
93313,18267,59924,30.5,7996,10271,568.8089816131502
93314,8928,34156,26.1,4808,4120,346.3687778989622
93401,4312,28773,15.0,1967,2345,448.0233119847911
93402,2773,15572,17.8,1502,1271,583.7748225033337
93405,1729,24991,6.9,892,837,404.4293850800834
93407,0,309,0.0,0,0,
93408,1,11,9.1,1,0,
93409,0,2591,0.0,0,0,
93410,96,6523,1.5,36,60,0.0
93420,6840,32126,21.3,3970,2870,151.52282592729537
93422,6647,33781,19.7,3212,3435,494.3018286478472
93424,64,1174,5.5,31,33,47.453416149068325
93426,261,1566,16.7,132,129,7.921020459945102
93427,1275,5980,21.3,747,528,89.16619888596226
93428,828,6056,13.7,401,427,74.50731745189633
93429,0,64,0.0,0,0,12.751775105057238
93430,224,2941,7.6,32,192,37.36897859054416
93432,364,1434,25.4,199,165,13.15431478086
93433,2744,12755,21.5,1219,1525,6229.667282809612
93434,2929,8272,35.4,1637,1292,335.61343506094886
93436,13957,55591,25.1,7040,6917,244.3727224490333
93437,1061,3681,28.8,596,465,73.4932473291675
93440,90,846,10.6,90,0,30.732592424586073
93441,147,1085,13.5,51,96,22.295302708581488
93442,1420,11399,12.5,732,688,245.86484727427788
93444,4623,22079,20.9,2073,2550,342.25817303281445
93445,1504,6912,21.8,619,885,430.468245108983
93446,9962,45720,21.8,4870,5092,104.9638369698696
93449,952,8050,11.8,415,537,811.7492681942061
93450,269,830,32.4,162,107,4.736373243917688
93451,1086,4751,22.9,370,716,9.465076706698897
93452,89,307,29.0,24,65,4.817968394127334
93453,175,2096,8.3,102,73,3.4915524390967088
93454,12092,41110,29.4,5421,6671,97.06300727972554
93455,10383,44186,23.5,4746,5637,382.38102884379725
93458,20127,59789,33.7,10246,9881,1990.7801668015625
93460,1163,6280,18.5,661,502,27.36881327589654
93461,312,1369,22.8,162,150,4.884266340369124
93463,1310,8059,16.3,702,608,231.4522552287678
93465,2184,9829,22.2,1296,888,111.830523293595
93501,1391,5404,25.7,706,685,21.611639115355164
93505,3467,14952,23.2,2003,1464,215.21070439864656
93510,1370,7397,18.5,753,617,92.82315771070346
93512,16,313,5.1,4,12,2.4200587161786875
93513,299,1649,18.1,84,215,3.682336128481017
93514,2991,14692,20.4,1479,1512,14.321347078437253
93516,644,2583,24.9,283,361,84.21421071053553
93517,35,587,6.0,6,29,1.858163174584358
93518,102,894,11.4,57,45,2.5685380300885883
93519,0,0,,0,0,0.0
93522,0,86,0.0,0,0,1.8332552502393415
93523,1540,3867,39.8,555,985,97.24717320088769
93524,0,93,0.0,0,0,2.263817569432941
93526,215,855,25.1,84,131,14.331626742404424
93527,368,1734,21.2,205,163,4.825565790450519
93528,0,94,0.0,0,0,19.567876070118224
93529,17,302,5.6,0,17,5.511443250817375
93530,0,28,0.0,0,0,5.203816131830009
93531,43,425,10.1,0,43,19.03247319550608
93532,520,2768,18.8,194,326,21.609086141339976
93534,11883,42515,28.0,5449,6434,2099.3828137363507
93535,24534,80905,30.3,11727,12807,313.59290332029207
93536,16992,72131,23.6,8448,8544,269.60244696409757
93541,298,817,36.5,102,196,0.8381675011579947
93543,3559,12745,27.9,1876,1683,215.7662249405369
93544,178,1427,12.5,67,111,9.44627107144721
93545,391,1342,29.1,187,204,3.89137888274984
93546,1833,8689,21.1,733,1100,41.427660930529
93549,0,254,0.0,0,0,0.5520884312194886
93550,24358,81501,29.9,12173,12185,291.6714881930462
93551,13948,54478,25.6,6779,7169,601.4677426966822
93552,12668,43371,29.2,5470,7198,1034.7554630593131
93553,96,1136,8.5,63,33,26.452898804112177
93554,0,65,0.0,0,0,0.7329532834826387
93555,8700,33490,26.0,5110,3590,434.44575350886186
93558,0,17,0.0,0,0,0.4205318491032777
93560,6279,21300,29.5,3042,3237,124.97766979884956
93561,7205,31060,23.2,3506,3699,116.40304550364122
93562,559,1867,29.9,192,367,19.63128491620112
93563,72,222,32.4,47,25,11.080552176442588
93581,0,3611,0.0,0,0,
93591,2345,7340,31.9,1251,1094,88.22183951348151
93601,103,1206,8.5,66,37,35.79000504795558
93602,518,3038,17.1,264,254,29.989733244474863
93603,0,249,0.0,0,0,1.3094353640416048
93604,49,366,13.4,27,22,8.236750309440756
93605,36,97,37.1,8,28,10.701305693902274
93606,406,1129,36.0,219,187,1121.3872832369943
93608,289,1018,28.4,146,143,8.926912487542861
93609,1298,4889,26.5,479,819,87.38150687178143
93610,5470,23795,23.0,2489,2981,88.45814777097172
93611,12296,46620,26.4,6639,5657,4718.916820343589
93612,10081,37138,27.1,4493,5588,5257.113218731476
93614,2542,11760,21.6,1331,1211,94.438908955038
93615,1932,5767,33.5,853,1079,393.6983406873407
93616,637,2163,29.4,256,381,172.0258401683966
93618,10842,32334,33.5,4789,6053,477.8780903410959
93619,15693,50848,30.9,7372,8321,230.67520185286455
93620,2189,9363,23.4,1378,811,52.40900353444534
93621,0,173,0.0,0,0,1.5435328589367938
93622,3269,9419,34.7,1825,1444,20.680885827982113
93623,0,4,0.0,0,0,3.1493541155119034
93624,249,892,27.9,121,128,6.48697401741423
93625,2501,8396,29.8,1281,1220,320.97272044715106
93626,651,2583,25.2,198,453,24.765810316407347
93627,110,196,56.1,110,0,2.149054576363607
93628,0,310,0.0,0,0,4.607707147526347
93630,6555,20272,32.3,3388,3167,127.77092836888175
93631,4209,16588,25.4,2195,2014,195.81783598454103
93633,0,26,0.0,0,0,0.0
93634,0,29,0.0,0,0,0.0232303026392204
93635,16245,47683,34.1,8405,7840,106.37105360140863
93636,3435,13447,25.5,1457,1978,63.41789390019794
93637,12756,41324,30.9,6262,6494,146.5690015477116
93638,16330,51724,31.6,8064,8266,568.9200567225029
93640,5010,14162,35.4,2200,2810,85.97534335049295
93641,27,216,12.5,0,27,4.126677945198982
93643,422,3115,13.5,127,295,20.05954254537824
93644,1208,7169,16.9,702,506,70.62600321027287
93645,203,897,22.6,97,106,3.718904430856856
93646,3701,10157,36.4,1624,2077,327.76368355057883
93647,4003,11828,33.8,1895,2108,123.327534737882
93648,4852,15370,31.6,2503,2349,747.9766695302255
93650,660,2844,23.2,321,339,4616.0
93651,364,1580,23.0,146,218,140.57606092243444
93652,66,378,17.5,37,29,272.77131782945736
93653,254,1378,18.4,141,113,6.094881981771442
93654,8818,30476,28.9,4612,4206,306.43556475364164
93656,1624,6249,26.0,926,698,51.27978661390896
93657,10036,36053,27.8,5064,4972,161.89059088714998
93660,1444,3921,36.8,800,644,83.7213118116373
93662,7905,30191,26.2,3897,4008,391.1200729505144
93664,9,288,3.1,0,9,1.9667983181216544
93665,40,386,10.4,40,0,940.7265774378584
93666,272,704,38.6,116,156,4853.773584905661
93667,328,1909,17.2,196,132,17.936610388286848
93668,271,1025,26.4,103,168,25.22651306523156
93669,54,324,16.7,33,21,45.248868778280546
93670,0,108,0.0,0,0,
93673,74,378,19.6,36,38,901.1553273427472
93675,1587,4891,32.4,753,834,38.017261347271315
93701,2978,10602,28.1,1475,1503,6836.291913214991
93702,14483,45248,32.0,6919,7564,8452.03094777563
93703,9601,32603,29.4,4452,5149,6742.70111321151
93704,7670,29502,26.0,3985,3685,5411.339633129516
93705,11677,38777,30.1,5777,5900,7475.84789311408
93706,13081,41523,31.5,6100,6981,262.0656583820755
93710,6737,32730,20.6,3722,3015,5527.782277660781
93711,8590,39963,21.5,4244,4346,3448.6447931526395
93720,10956,48597,22.5,5092,5864,4475.1460588066275
93721,1068,8004,13.3,422,646,4152.376286134248
93722,24263,86387,28.1,11673,12590,4446.165803108808
93723,4094,13174,31.1,1910,2184,335.833069562465
93725,8359,26568,31.5,3700,4659,405.47156012596827
93726,12099,44790,27.0,5449,6650,6730.1363422661025
93727,25530,82176,31.1,12596,12934,3852.0271192610458
93728,4444,17892,24.8,2168,2276,5502.3011176857335
93730,3174,12461,25.5,1545,1629,1597.534629559029
93737,1923,6624,29.0,979,944,
93740,22,1174,1.9,20,2,
93741,2,77,2.6,0,2,
93901,7467,29498,25.3,3515,3952,2930.2107239724596
93905,21398,63121,33.9,9710,11688,6670.238095238095
93906,18816,66883,28.1,9070,9746,4806.410256410257
93907,6251,25124,24.9,3251,3000,446.33752705131496
93908,3412,12983,26.3,1838,1574,50.61216019921146
93920,409,1790,22.8,259,150,9.022708200569124
93921,259,2469,10.5,139,120,3099.7899159663866
93923,2032,12630,16.1,1029,1003,63.74215061931798
93924,1140,6563,17.4,567,573,34.33561310539178
93925,467,1352,34.5,177,290,35.931741708059604
93926,2437,8941,27.3,1369,1068,132.42301506939066
93927,7254,19983,36.3,3908,3346,87.3037402970726
93928,28,1040,2.7,0,28,26.53714940493242
93930,5473,16807,32.6,2895,2578,51.271219770839586
93932,15,370,4.1,7,8,6.615883391760457
93933,6067,27197,22.3,2758,3309,2346.9464218808544
93940,4598,31513,14.6,2357,2241,930.4820442775026
93943,0,12,0.0,0,0,0.0
93944,107,2605,4.1,0,107,
93950,2585,15098,17.1,1565,1020,5509.615384615385
93953,482,3416,14.1,251,231,467.0947030497592
93954,189,501,37.7,110,79,7.339511034401864
93955,7241,32610,22.2,3332,3909,1321.50868788259
93960,6453,26037,24.8,2840,3613,155.10914322140482
93962,0,198,0.0,0,0,3057.377049180328
94002,6395,27893,22.9,2628,3767,4801.0312944523475
94005,959,4756,20.2,497,462,1014.1921397379912
94010,10367,43458,23.9,4488,5879,2808.5978835978835
94014,6909,46331,14.9,3613,3296,7755.437333750587
94015,10292,65125,15.8,5535,4757,11527.404526166903
94018,589,3423,17.2,253,336,
94019,2832,15275,18.5,1542,1290,338.31703723546747
94020,339,2030,16.7,188,151,47.15272813914701
94021,34,123,27.6,0,34,52.348381212950294
94022,4515,20052,22.5,2369,2146,1113.7430041268583
94024,5901,24041,24.5,2649,3252,2865.2242233772513
94025,9500,41017,23.2,4856,4644,5259.533771667663
94027,1419,7142,19.9,611,808,1430.873284264969
94028,1089,6888,15.8,605,484,387.85289532936895
94030,4319,22825,18.9,2056,2263,6816.24184943687
94037,154,2649,5.8,116,38,514.903671392221
94038,776,3165,24.5,317,459,564.1630178511283
94040,7714,35667,21.6,3890,3824,9509.289617486338
94041,3258,15222,21.4,1513,1745,8796.983029541168
94043,6522,32670,20.0,3280,3242,3783.282099787184
94044,7338,38061,19.3,3646,3692,2563.42788971368
94060,145,1312,11.1,28,117,14.948537820617547
94061,8000,37539,21.3,3590,4410,9882.931882931882
94062,5722,26531,21.6,2777,2945,431.0126190770753
94063,7779,34807,22.3,4001,3778,5553.67579206398
94065,2697,11588,23.3,1456,1241,5057.977332170881
94066,8111,43369,18.7,3811,4300,7349.50495049505
94070,7328,31312,23.4,3531,3797,4969.776180362685
94074,48,151,31.8,0,48,7.654716083553172
94080,11389,66262,17.2,5477,5912,6608.66574965612
94085,3946,22996,17.2,1920,2026,6715.6276686592655
94086,9214,49217,18.7,4560,4654,11264.025646897184
94087,14312,58913,24.3,6780,7532,8650.432407828857
94089,3322,23447,14.2,1502,1820,3787.838948233361
94102,3252,34077,9.5,1852,1400,50247.73413897281
94103,3031,32400,9.4,1061,1970,22987.62736535662
94104,52,557,9.3,29,23,5615.384615384615
94105,624,13722,4.5,166,458,26255.57809330629
94107,2854,30340,9.4,1654,1200,16269.441401971522
94108,1130,12070,9.4,554,576,52461.24031007752
94109,3574,56333,6.3,1764,1810,51711.77015755329
94110,10330,69679,14.8,4765,5565,30445.60669456067
94111,476,4468,10.7,139,337,12154.078549848942
94112,13781,80880,17.0,7190,6591,25503.148425787105
94114,3813,33858,11.3,1972,1841,25326.353790613717
94115,3558,33299,10.7,1515,2043,29789.612676056346
94116,7428,43903,16.9,3579,3849,18445.764053840063
94117,4162,39496,10.5,2168,1994,34138.03921568628
94118,5650,40108,14.1,2657,2993,20569.07730673317
94121,7048,43304,16.3,3669,3379,17295.06903353057
94122,8580,59453,14.4,4397,4183,18805.035308566163
94123,3251,24721,13.2,1707,1544,24300.09319664492
94124,8541,37347,22.9,3825,4716,7776.634512325831
94127,3704,21184,17.5,1827,1877,10945.308310991955
94128,0,0,,0,0,51.58020274299344
94129,1011,3952,25.6,430,581,1700.2967359050444
94130,496,3136,15.8,134,362,3614.0749148694663
94131,4678,28705,16.3,2380,2298,15063.30365974283
94132,3310,27641,12.0,1571,1739,9718.071519795658
94133,2667,25460,10.5,1212,1455,40927.05167173252
94134,6546,40738,16.1,3217,3329,16915.20125048847
94158,1855,10205,18.2,1127,728,16783.636363636364
94188,0,0,,0,0,
94301,3314,17259,19.2,1732,1582,7371.308016877637
94303,11719,47989,24.4,5655,6064,5667.4961488328
94304,771,4489,17.2,456,315,913.4595381734968
94305,1117,17279,6.5,571,546,3406.4853556485355
94306,6178,27785,22.2,3167,3011,6768.665850673195
94401,6636,35392,18.8,3115,3521,11254.580520732885
94402,5849,26150,22.4,3174,2675,5141.782178217822
94403,8526,43858,19.4,3912,4614,7875.199715959524
94404,7872,36397,21.6,3895,3977,8295.632183908046
94501,13453,63340,21.2,6505,6948,8138.187783947501
94502,3117,14225,21.9,1324,1793,6082.474226804125
94503,5524,21791,25.3,2833,2691,751.1936928600511
94505,3405,15445,22.0,1516,1889,958.13339731286
94506,6616,26947,24.6,3475,3141,1454.920668953688
94507,3112,14503,21.5,1482,1630,1255.49205215217
94508,514,3406,15.1,230,284,254.98032848310743
94509,17605,70889,24.8,9697,7908,3972.426049071314
94510,5575,27223,20.5,2588,2987,969.938986769041
94511,299,1993,15.0,124,175,383.66336633663366
94512,0,57,0.0,0,0,0.8105552303327779
94513,17035,67580,25.2,8775,8260,830.0341123806384
94514,438,2023,21.7,148,290,69.33893109422897
94515,941,7024,13.4,419,522,64.64943254551234
94516,30,212,14.2,25,5,64.48934403542762
94517,2814,12349,22.8,1230,1584,271.765322158198
94518,5712,28287,20.2,2795,2917,5205.919509113878
94519,4308,20162,21.4,2064,2244,4479.056437389771
94520,8224,36699,22.4,3993,4231,3921.089951377634
94521,7519,41092,18.3,3650,3869,4429.515645977486
94523,6870,34964,19.6,3132,3738,4847.210657785179
94525,498,3599,13.8,288,210,1317.699836867863
94526,8270,33396,24.8,3665,4605,2561.7312072892937
94528,231,726,31.8,129,102,696.7071057192375
94530,4669,26483,17.6,2375,2294,5987.29792147806
94531,9739,44115,22.1,5062,4677,3005.631593954947
94533,19021,78129,24.3,9982,9039,3493.5186007280477
94534,9441,41395,22.8,4465,4976,496.3743806771263
94535,1478,3873,38.2,688,790,354.82191210164547
94536,15836,71445,22.2,8044,7792,5295.446472970093
94538,13861,66215,20.9,7061,6800,4067.4041832910166
94539,12828,53464,24.0,6387,6441,2193.6590229312064
94541,14128,67401,21.0,6513,7615,8876.341201716737
94542,2550,16188,15.8,1134,1416,1751.127037336724
94544,16392,77712,21.1,7554,8838,7152.392257121987
94545,5773,33700,17.1,2470,3303,2248.066298342542
94546,9754,45761,21.3,4456,5298,2825.4057780284516
94547,5152,26041,19.8,2595,2557,4601.410934744268
94548,238,598,39.8,136,102,107.31285157940286
94549,6808,28456,23.9,3440,3368,1478.5851053108938
94550,10789,49463,21.8,5541,5248,193.46192311086273
94551,9346,40025,23.4,4870,4476,581.9836588667569
94552,3039,14948,20.3,1627,1412,293.82239382239385
94553,10043,49062,20.5,4537,5506,808.0118116623942
94555,10033,37671,26.6,5055,4978,2743.919162757127
94556,3516,15959,22.0,1686,1830,818.2997043415115
94558,12574,65084,19.3,6191,6383,166.4152540263361
94559,6332,28224,22.4,2924,3408,662.4050754590022
94560,9354,47470,19.7,4744,4610,2398.286511257222
94561,11230,44546,25.2,5246,5984,2481.7463521541035
94562,0,0,,0,0,
94563,4760,19416,24.5,2648,2112,942.8933391804318
94564,3340,18946,17.6,1659,1681,2811.6854590716066
94565,23560,100826,23.4,10863,12697,2147.1088247632083
94566,10362,45145,23.0,5206,5156,2216.9184587372665
94567,201,719,28.0,142,59,11.966235661860894
94568,18519,71068,26.1,8920,9599,3479.7502121983753
94569,0,251,0.0,0,0,188.18040435458784
94571,742,10514,7.1,367,375,94.68551210837964
94572,1927,9309,20.7,1106,821,1089.3538193309362
94573,17,107,15.9,0,17,45.572916666666664
94574,1180,7827,15.1,558,622,68.60016090104585
94575,0,1048,0.0,0,0,7304.347826086956
94576,29,171,17.0,29,0,433.0985915492958
94577,8534,47937,17.8,3813,4721,5979.0511398644485
94578,8513,42350,20.1,4763,3750,9315.200701908312
94579,3088,20272,15.2,1360,1728,6886.508951406649
94580,5395,29377,18.4,2814,2581,8928.657435279953
94582,13407,47338,28.3,7202,6205,3334.650659906047
94583,10185,39758,25.6,4482,5703,1814.230551893012
94585,7042,29401,24.0,2979,4063,276.39818817037224
94586,227,964,23.5,109,118,14.66101999066863
94587,12274,69502,17.7,5497,6777,3823.900972950945
94588,8388,35162,23.9,4221,4167,1109.468540012217
94589,6562,29959,21.9,3381,3181,5332.038834951456
94590,7220,37991,19.0,3666,3554,5695.261313423739
94591,11949,59026,20.2,5733,6216,2670.1900744181635
94592,75,1020,7.4,31,44,129.5880149812734
94595,1849,17341,10.7,1036,813,3397.853583748563
94596,3772,23795,15.9,1937,1835,3669.910920488287
94597,3965,23654,16.8,1873,2092,5739.698988403652
94598,5048,26346,19.2,2317,2731,1293.586882701077
94599,181,3428,5.3,46,135,386.6985766469329
94601,11837,52102,22.7,5870,5967,16600.187558612066
94602,5620,31104,18.1,2585,3035,8134.414513468939
94603,9965,37042,26.9,4921,5044,13152.705707931802
94605,8747,44477,19.7,4348,4399,4888.674971687429
94606,6362,38459,16.5,3271,3091,16182.287188306103
94607,4085,27019,15.1,1721,2364,4342.167454422687
94608,4261,34083,12.5,1993,2268,11472.383720930233
94609,3691,25175,14.7,1982,1709,14251.651651651651
94610,5051,32404,15.6,2394,2657,15089.90913438546
94611,6934,39780,17.4,3550,3384,5348.219178082192
94612,1528,17742,8.6,910,618,16913.361169102296
94613,20,612,3.3,20,0,3542.857142857143
94618,3219,17285,18.6,1415,1804,7061.494015683037
94619,5986,27018,22.2,2916,3070,2975.437335250419
94621,9728,34911,27.9,4849,4879,3972.280949025135
94702,3434,17473,19.7,1847,1587,13260.530421216848
94703,2854,20404,14.0,1125,1729,17035.714285714286
94704,1166,25711,4.5,527,639,34675.67567567567
94705,2268,14508,15.6,1130,1138,4026.027802425318
94706,4991,20860,23.9,2433,2558,14620.218579234974
94707,2329,12596,18.5,1102,1227,6746.311010215664
94708,2044,11810,17.3,1119,925,3573.2732732732734
94709,878,12200,7.2,358,520,18359.4674556213
94710,1273,8471,15.0,743,530,3760.648148148148
94720,253,5322,4.8,72,181,4012.765957446809
94801,8287,32759,25.3,4045,4242,2733.2232267037552
94803,4757,27171,17.5,2394,2363,2033.0759029565488
94804,10102,44387,22.8,4865,5237,6382.257816109656
94805,2738,14790,18.5,1236,1502,7663.270777479893
94806,14682,63730,23.0,6676,8006,8100.229240957718
94901,8336,40927,20.4,3919,4417,3147.2294306212793
94903,5044,31582,16.0,2366,2678,1518.6321347749558
94904,2725,13132,20.8,1361,1364,2692.3387911865775
94920,2504,12906,19.4,1302,1202,1934.2549923195088
94922,158,509,31.0,0,158,166.55196145905023
94923,129,1390,9.3,55,74,61.322707513972254
94924,101,1342,7.5,46,55,46.37015990966379
94925,2581,10155,25.4,1320,1261,3049.8287137963252
94928,8906,46231,19.3,4743,4163,5668.47405112316
94929,104,442,23.5,68,36,326.984126984127
94930,1584,8748,18.1,834,750,617.5995505302338
94931,1558,8945,17.4,829,729,1176.0827407886231
94933,192,1284,15.0,147,45,274.05792587978823
94937,60,938,6.4,28,32,16.36544755941369
94938,34,428,7.9,21,13,101.98270407087114
94939,1479,7488,19.8,907,572,2927.9661016949153
94940,41,260,15.8,10,31,9.3115554877118
94941,7637,32190,23.7,4041,3596,867.3296207902413
94945,3283,17309,19.0,1708,1575,784.5553145336225
94946,75,673,11.1,44,31,19.4239965611735
94947,4894,25183,19.4,2225,2669,1176.612719398222
94949,3736,18545,20.1,1619,2117,1339.5550246378975
94950,0,23,0.0,0,0,24.35500515995872
94951,765,3574,21.4,383,382,285.64760793465575
94952,6815,33519,20.3,3339,3476,177.30471445770388
94954,7423,38201,19.4,3363,4060,627.4907125970956
94956,27,1189,2.3,20,7,34.02575700826875
94957,598,2081,28.7,259,339,834.5070422535211
94960,3896,16028,24.3,1737,2159,2755.400578329648
94963,93,462,20.1,26,67,122.10394489668128
94964,0,2054,0.0,0,0,6489.035087719298
94965,1547,12044,12.8,660,887,784.6069419673481
94970,7,400,1.8,7,0,90.31811894882432
94971,47,364,12.9,36,11,8.88548103378287
94972,70,153,45.8,0,70,49.769787327340495
94973,101,1438,7.0,34,67,383.44722854973423
95002,416,1920,21.7,142,274,234.9932143229982
95003,4407,24977,17.6,2236,2171,778.1033153430996
95004,589,3902,15.1,403,186,195.6096005829576
95005,1678,7552,22.2,904,774,654.5593091186182
95006,1141,8802,13.0,453,688,171.4187315340137
95007,42,359,11.7,22,20,249.05422446406052
95008,10718,48746,22.0,5266,5452,7409.252669039146
95010,1325,9243,14.3,495,830,6441.070137382501
95012,3921,10528,37.2,1914,2007,780.7805482422177
95013,0,53,0.0,0,0,19.165727170236753
95014,14762,61414,24.0,6902,7860,2473.0490748189864
95017,201,907,22.2,101,100,13.30813702096312
95018,778,6055,12.8,388,390,363.8865004299226
95019,1843,5891,31.3,855,988,7969.917958067457
95020,18589,68365,27.2,8996,9593,418.4998517640083
95023,15165,57367,26.4,7496,7669,137.26736705603454
95030,2409,13373,18.0,1236,1173,1292.7731411229136
95032,6759,27678,24.4,3145,3614,1385.6002571382653
95033,1886,9853,19.1,987,899,110.75843261729663
95035,16409,79393,20.7,7409,9000,3359.6487317790757
95037,13196,51867,25.4,7327,5869,432.7853561851463
95039,434,1427,30.4,155,279,69.56671845330571
95041,169,803,21.0,97,72,1798.9690721649483
95043,147,669,22.0,84,63,0.9503131327523396
95045,678,4063,16.7,224,454,91.70241088596362
95046,820,5801,14.1,451,369,313.92876129718235
95050,6855,39905,17.2,3016,3839,7128.13932172319
95051,11271,60499,18.6,5182,6089,8983.310575026551
95053,50,3317,1.5,30,20,26088.43537414966
95054,4856,24444,19.9,2499,2357,3730.1883854896464
95060,6449,46527,13.9,2726,3723,896.6414900637969
95062,5568,36369,15.3,3144,2424,7206.214130219672
95064,343,9832,3.5,168,175,6240.893066980024
95065,1570,8125,19.3,902,668,746.0477017271315
95066,2590,15233,17.0,1122,1468,815.7979064302499
95070,6285,31688,19.8,2988,3297,1110.161711743521
95073,2462,11408,21.6,1090,1372,492.9694323144105
95075,115,566,20.3,81,34,4.66557911908646
95076,22182,83716,26.5,11198,10984,623.8693058166906
95110,4373,20314,21.5,2045,2328,4400.351957765068
95111,14902,59761,24.9,6979,7923,10539.707149009477
95112,8349,58775,14.2,4330,4019,8247.455295735901
95113,43,2161,2.0,43,0,7327.586206896552
95116,11719,50436,23.2,5203,6516,15364.197530864198
95117,6671,28663,23.3,3374,3297,13664.655172413792
95118,8002,32827,24.4,3948,4054,8059.026069847517
95119,2364,10461,22.6,1065,1299,2457.666980244591
95120,8766,38003,23.1,4337,4429,971.4002188239484
95121,6966,36657,19.0,2993,3973,8606.974128233971
95122,12664,52555,24.1,6518,6146,11630.90757005437
95123,15271,70952,21.5,7498,7773,8949.757095372028
95124,13157,51803,25.4,6496,6661,7900.576806314512
95125,11112,53333,20.8,5899,5213,7422.923816060398
95126,6346,36996,17.2,2989,3357,11143.415514131088
95127,13750,62269,22.1,6591,7159,3321.948399978982
95128,5961,33653,17.7,2676,3285,9154.413635207326
95129,8828,39797,22.2,4362,4466,8826.868288406751
95130,3282,13376,24.5,1707,1575,9764.419735927728
95131,6037,31335,19.3,2879,3158,5557.748917748918
95132,7111,40981,17.4,3301,3810,1562.022447263554
95133,5604,28749,19.5,2872,2732,8634.77460901564
95134,4384,30916,14.2,2421,1963,2821.8911917098444
95135,4431,21402,20.7,1996,2435,173.89255419415645
95136,10186,47294,21.5,4913,5273,9320.00768787238
95138,4819,19420,24.8,2148,2671,791.0969426947304
95139,1989,7232,27.5,950,1039,6026.55601659751
95140,0,91,0.0,0,0,0.7287207047770246
95148,9346,45688,20.5,4736,4610,6168.84434859825
95202,1447,6000,24.1,580,867,6233.018867924528
95203,4282,16237,26.4,2134,2148,2524.087591240876
95204,7005,30406,23.0,3444,3561,5443.228970199925
95205,12472,40128,31.1,6624,5848,4130.018907796686
95206,20409,68031,30.0,10501,9908,492.6673671570099
95207,13496,52877,25.5,7117,6379,7128.346674027049
95209,12433,46756,26.6,6164,6269,5380.55353241078
95210,12704,42654,29.8,6214,6490,5476.196738558653
95211,35,1676,2.1,20,15,23666.666666666664
95212,6669,27848,23.9,3388,3281,1335.143045982438
95215,6514,25647,25.4,3168,3346,274.43734580204483
95219,8124,30165,26.9,3810,4314,249.15925757951752
95220,2207,8244,26.8,1050,1157,141.71790764567078
95221,43,398,10.8,43,0,
95222,928,5236,17.7,356,572,35.692169857310375
95223,222,2470,9.0,158,64,6.096718034991694
95224,76,311,24.4,37,39,16.921207913918778
95225,131,1019,12.9,90,41,63.79025598678778
95226,0,0,,0,0,0.0
95227,242,1180,20.5,80,162,19.285338938518127
95228,871,4648,18.7,445,426,49.07827799354521
95230,128,513,25.0,66,62,4.829117900612225
95231,840,4865,17.3,429,411,512.8205128205128
95232,0,202,0.0,0,0,41.001817814582914
95233,0,233,0.0,0,0,236.49906890130353
95236,1198,4518,26.5,658,540,34.958947937986686
95237,963,3992,24.1,362,601,492.91975724882
95240,13417,50245,26.7,6151,7266,725.0502295158901
95242,6269,27433,22.9,2850,3419,300.8693738307472
95245,416,2813,14.8,126,290,23.63558229480017
95246,44,1548,2.8,44,0,17.864898514636476
95247,657,4022,16.3,268,389,81.9351408825093
95248,62,106,58.5,19,43,3.419669431954911
95249,913,4908,18.6,530,383,73.71842221893928
95251,0,521,0.0,0,0,40.59916509781452
95252,3001,14622,20.5,1557,1444,138.4159232260498
95253,229,504,45.4,111,118,
95254,0,350,0.0,0,0,147.86710418375716
95255,321,1787,18.0,142,179,36.05338892791588
95257,0,398,0.0,0,0,32.81754803604829
95258,703,3885,18.1,452,251,1186.703945324635
95301,11626,41660,27.9,5071,6555,524.8474968447623
95303,177,891,19.9,85,92,35.269278693063825
95304,3362,15235,22.1,1657,1705,101.21130376422909
95305,0,158,0.0,0,0,0.0
95306,114,784,14.5,96,18,5.051263416479972
95307,13940,47978,29.1,6390,7550,1435.8396295393616
95309,0,0,,0,0,
95310,428,1849,23.1,246,182,36.97824677502292
95311,373,2182,17.1,119,254,8.162118846398506
95312,94,284,33.1,49,45,210.20408163265307
95313,126,860,14.7,70,56,25.49358287600848
95315,3913,13317,29.4,1688,2225,762.010347376201
95316,1614,7154,22.6,1160,454,98.898546472537
95317,319,948,33.6,174,145,23.490950030310906
95318,121,522,23.2,77,44,4.744813096384488
95319,265,1651,16.1,143,122,613.0693069306931
95320,3184,12385,25.7,1662,1522,146.40083850826676
95321,417,4068,10.3,243,174,7.891426090248165
95322,2496,9392,26.6,1019,1477,59.129469688472234
95323,388,1516,25.6,202,186,47.39548401520233
95324,2439,8763,27.8,896,1543,217.60135471660524
95325,0,44,0.0,0,0,2.1842131792062904
95326,2668,10672,25.0,1311,1357,402.58858156295986
95327,1240,8788,14.1,676,564,53.80177365716013
95328,1405,3856,36.4,652,753,4070.796460176991
95329,331,2394,13.8,202,129,19.885047610877585
95330,8853,30051,29.5,4265,4588,1119.4425087108016
95333,1096,3157,34.7,484,612,24.622930717351316
95334,5102,17302,29.5,2755,2347,312.07833832096753
95335,0,58,0.0,0,0,2.142996298460939
95336,11365,49145,23.1,5864,5501,1232.3403589315526
95337,12260,44192,27.7,5227,7033,895.0357732526143
95338,2068,10102,20.5,1068,1000,31.26552911460891
95340,8606,36833,23.4,4393,4213,700.6178185807495
95341,12264,34541,35.5,6132,6132,231.8883024008173
95345,86,528,16.3,45,41,18.804407858401493
95346,180,1041,17.3,85,95,226.8545703660207
95348,9162,35853,25.6,4292,4870,581.4391050088991
95350,14150,55368,25.6,6984,7166,6116.342236306021
95351,14530,48134,30.2,7582,6948,5492.409760485775
95354,6677,25100,26.6,3253,3424,3198.45832244578
95355,14336,60338,23.8,6725,7611,6341.964476781511
95356,7940,33033,24.0,4298,3642,1458.0857194309383
95357,4212,14403,29.2,1711,2501,330.64803049555275
95358,9795,31268,31.3,4314,5481,280.2260178543784
95360,3465,13781,25.1,2271,1194,219.5457339761219
95361,8779,35107,25.0,4172,4607,159.2552389012566
95363,8890,29784,29.8,4304,4586,59.23551831339861
95364,0,0,,0,0,0.0
95365,1144,3882,29.5,499,645,1171.0777626193724
95366,4680,18500,25.3,1999,2681,545.7035461406218
95367,7525,25162,29.9,3624,3901,4755.521706016756
95368,3081,14849,20.7,1627,1454,4982.358706305129
95369,145,778,18.6,53,92,6.265535709709658
95370,5179,28548,18.1,2668,2511,274.5111352525801
95372,405,1639,24.7,178,227,727.6859504132232
95374,421,1581,26.6,220,201,38.55844506433906
95375,0,64,0.0,0,0,0.3585000358500036
95376,14639,55038,26.6,6866,7773,7259.551004332415
95377,9314,35001,26.6,3985,5329,296.45965387728376
95379,799,3828,20.9,284,515,148.96658296310605
95380,12005,44204,27.2,6232,5773,569.9306590629253
95382,9660,38727,24.9,4440,5220,3474.5545911375057
95383,461,3415,13.5,110,351,57.62435444414243
95385,137,531,25.8,59,78,16.017880424660085
95386,2864,10387,27.6,1258,1606,110.82125807950658
95387,483,1215,39.8,136,347,27.87844995818233
95388,4262,13518,31.5,1938,2324,366.2192275042445
95389,52,1963,2.6,52,0,4.86834841944945
95391,7362,23696,31.1,3540,3822,800.178744321144
95401,7006,36905,19.0,3823,3183,1859.5484117872177
95403,9968,44677,22.3,4761,5207,2075.951717734448
95404,7256,37437,19.4,3346,3910,510.17376309855416
95405,4297,23748,18.1,2030,2267,4560.406698564593
95407,10890,42138,25.8,5403,5487,1981.1669982879089
95409,4192,26158,16.0,1720,2472,764.1242534221129
95410,34,797,4.3,34,0,32.30748734345857
95412,69,271,25.5,56,13,5.36973682753734
95415,413,1383,29.9,242,171,23.023222165955293
95417,82,211,38.9,82,0,10.70877953248052
95419,0,169,0.0,0,0,
95420,100,351,28.5,99,1,32.28021978021978
95421,223,1679,13.3,128,95,11.591008947812565
95422,4438,16998,26.1,2235,2203,581.9074542478797
95423,507,3322,15.3,293,214,29.379094042504533
95425,2190,11331,19.3,1227,963,58.01749271137026
95426,211,1178,17.9,164,47,39.22115988554679
95427,55,589,9.3,32,23,9.721138153693325
95428,683,2775,24.6,281,402,10.27054381819572
95429,0,118,0.0,0,0,3.30526481466908
95430,0,0,,0,0,54.6218487394958
95431,4,76,5.3,2,2,1008.3333333333334
95432,17,614,2.8,0,17,8.275708850565136
95435,144,347,41.5,0,144,22357.142857142855
95436,1275,6008,21.2,396,879,310.63849809438665
95437,2887,14865,19.4,1410,1477,85.11142053429994
95439,173,782,22.1,56,117,166.47919010123735
95441,243,1819,13.4,107,136,10.790863396322454
95442,237,2592,9.1,38,199,125.91642963022316
95443,113,190,59.5,36,77,43.86385426653883
95444,46,516,8.9,34,12,1136.9426751592357
95445,339,2012,16.8,173,166,22.299706258268493
95446,368,4709,7.8,185,183,159.47304000515365
95448,2475,16745,14.8,1412,1063,93.88221036799791
95449,326,1785,18.3,155,171,10.056091768154026
95450,42,272,15.4,17,25,5.966076301567767
95451,2583,12957,19.9,1341,1242,129.5578385130624
95452,134,1240,10.8,84,50,45.13846529218007
95453,2186,11254,19.4,958,1228,128.7976283494967
95454,218,1714,12.7,85,133,7.062354226810849
95456,167,775,21.5,84,83,60.18886241284971
95457,615,3252,18.9,399,216,20.693338381038657
95458,520,3303,15.7,274,246,80.97340059619354
95459,188,853,22.0,62,126,14.122722753088292
95460,249,2349,10.6,98,151,60.902255639097746
95461,767,3909,19.6,390,377,22.268900667902916
95462,99,1091,9.1,65,34,338.49557522123894
95463,4,88,4.5,0,4,15.076071922544951
95464,594,2466,24.1,259,335,1070.16160819866
95465,173,1251,13.8,110,63,39.684685621581146
95466,115,880,13.1,10,105,9.173062518847091
95467,1357,5795,23.4,488,869,803.2898314301251
95468,362,1822,19.9,208,154,22.557258197396607
95469,223,1323,16.9,153,70,8.120963897195857
95470,1376,6068,22.7,586,790,77.03808058881877
95471,163,780,20.9,126,37,160.3268526345449
95472,4545,28443,16.0,2287,2258,422.5492428555163
95476,5861,36386,16.1,3068,2793,345.1415405483245
95480,3,6,50.0,2,1,
95482,8413,34183,24.6,4458,3955,107.81427415571436
95485,476,2909,16.4,252,224,32.23581348293939
95486,0,27,0.0,0,0,2315.7894736842104
95488,21,366,5.7,15,6,3.1300435271678
95490,2865,14360,20.0,1294,1571,31.923723434677377
95492,6477,28096,23.1,2909,3568,1490.9035779260155
95493,0,144,0.0,0,0,12.600229095074456
95494,0,151,0.0,0,0,1.4520424862818089
95497,72,1224,5.9,43,29,75.87293252822263
95501,4519,23706,19.1,1960,2559,3263.114865785529
95503,4418,24072,18.4,2166,2252,294.2103942952018
95511,0,102,0.0,0,0,3.344319503683598
95514,33,117,28.2,17,16,1.059744300228477
95519,4125,18781,22.0,1844,2281,350.2334145479569
95521,2924,21712,13.5,1743,1181,351.08674044132266
95524,335,1700,19.7,122,213,217.1878847574489
95525,148,1358,10.9,80,68,15.132231761508264
95526,133,638,20.8,94,39,1.664500174376209
95527,246,701,35.1,144,102,3.041142411758156
95528,323,1555,20.8,165,158,19.856170774447552
95531,5012,23029,21.8,2400,2612,127.0045781211222
95536,594,3258,18.2,245,349,18.931689842266643
95537,0,629,0.0,0,0,1936.241610738255
95538,119,1022,11.6,55,64,
95540,3050,14415,21.2,1634,1416,420.8112874779541
95542,454,2862,15.9,205,249,10.30364317144497
95543,25,376,6.6,0,25,4.453286511285435
95545,54,492,11.0,12,42,0.8090257858582293
95546,706,2666,26.5,378,328,40.091913025584745
95547,162,1121,14.5,86,76,101.11602847796806
95548,232,1034,22.4,98,134,20.109951112941637
95549,270,1140,23.7,156,114,7.840367805489699
95550,22,213,10.3,0,22,1.2670443244517455
95551,255,1789,14.3,156,99,37.76655972825061
95552,8,423,1.9,8,0,5.106327024085207
95553,265,1037,25.6,142,123,11.160364315340868
95554,41,313,13.1,0,41,12.826399730614993
95555,60,370,16.2,31,29,3.5055549563153923
95556,283,692,40.9,248,35,5.421765708225593
95558,27,246,11.0,17,10,2.4280922556324023
95559,0,0,,0,0,5.543478260869565
95560,253,1337,18.9,206,47,91.91132414619533
95562,974,3396,28.7,306,668,206.1880589799372
95563,84,911,9.2,0,84,8.94451675394255
95564,96,564,17.0,52,44,138.9303854197789
95565,195,860,22.7,148,47,19.652080983197767
95567,410,2001,20.5,203,207,30.206550085595893
95568,19,224,8.5,15,4,2.175190458027071
95569,0,91,0.0,0,0,4.451986060174795
95570,478,2523,18.9,282,196,49.61722762070216
95571,0,30,0.0,0,0,18.847849217206264
95573,257,1417,18.1,72,185,10.70958278465821
95585,59,545,10.8,36,23,7.1628351183573225
95587,0,0,,0,0,3.238950997805872
95589,210,1153,18.2,74,136,7.461025956516616
95595,24,143,16.8,7,17,0.2894544507239979
95601,29,352,8.2,15,14,65.92341250605914
95602,2669,18610,14.3,1233,1436,374.1771846125974
95603,4935,28366,17.4,2637,2298,836.8750699026954
95604,0,34,0.0,0,0,1240.0
95605,3461,14291,24.2,1694,1767,3710.695050012824
95606,10,185,5.4,3,7,8.104638099823463
95607,0,235,0.0,0,0,2.2874830137399966
95608,12148,63715,19.1,6090,6058,4711.974599334744
95610,9428,46219,20.4,4805,4623,5918.768920282543
95612,306,1462,20.9,205,101,23.032056220227332
95613,0,0,,0,0,
95614,857,4479,19.1,463,394,140.00944733112897
95615,214,1147,18.7,95,119,41.45396105123842
95616,5409,52090,10.4,2677,2732,1802.2106849773909
95618,5101,26946,18.9,2559,2542,847.7435418611889
95619,1581,6414,24.6,665,916,1095.6873315363882
95620,5713,22004,26.0,2694,3019,92.4784574765716
95621,8446,42089,20.1,4147,4299,6255.430711610487
95623,709,4488,15.8,241,468,88.42364532019705
95624,17597,67915,25.9,8238,9359,1471.1874080741115
95625,0,88,0.0,0,0,190.01085776330075
95626,1117,5845,19.1,544,573,155.95405469931293
95627,1429,4137,34.5,697,732,86.31663449224946
95628,8601,44256,19.4,4239,4362,3174.2165684145207
95629,61,747,8.2,28,33,8.960353504357432
95630,18900,76599,24.7,9751,9149,3038.485033598045
95631,1392,6244,22.3,490,902,37.95816784591421
95632,7230,31217,23.2,3399,3831,282.88009888751543
95633,791,3305,23.9,511,280,113.58337557019766
95634,509,3878,13.1,197,312,33.057642208564125
95635,71,948,7.5,37,34,27.10843373493976
95636,392,1374,28.5,179,213,120.49873572238208
95637,25,276,9.1,13,12,3.3112582781456954
95638,325,2246,14.5,178,147,26.699240903935085
95639,46,314,14.6,26,20,66.6954457155191
95640,2058,12518,16.4,1163,895,90.35213893772308
95641,219,1517,14.4,96,123,34.75133384146341
95642,1062,7152,14.8,427,635,98.47926475233528
95645,283,1162,24.4,208,75,13.763913345503305
95646,85,249,34.1,29,56,2.922114412018132
95648,12647,55350,22.8,6137,6510,365.75004504566937
95650,2665,14098,18.9,903,1762,663.2568306010929
95651,166,738,22.5,121,45,35.91201556187341
95652,431,1193,36.1,194,237,169.92239764516992
95653,1,455,0.2,0,1,91.3890405971236
95655,1540,4954,31.1,904,636,454.8221219435408
95658,1070,5974,17.9,564,506,278.53587366975626
95659,201,790,25.4,138,63,16.28636126110434
95660,9888,35458,27.9,4491,5397,5793.863099921321
95661,6632,32827,20.2,3574,3058,3557.181148090239
95662,6883,32436,21.2,3376,3507,2994.9102350545995
95663,430,2659,16.2,258,172,320.30801057349726
95664,166,1133,14.7,111,55,34.835619420857824
95665,828,4693,17.6,396,432,184.05725567620925
95666,686,5885,11.7,240,446,55.87377195593927
95667,6425,36084,17.8,3324,3101,209.67589306837
95668,80,507,15.8,45,35,9.04893813481071
95669,367,2514,14.6,185,182,64.69889064976228
95670,14066,59449,23.7,7334,6732,4429.976000619339
95671,0,4478,0.0,0,0,
95672,1034,5744,18.0,463,571,300.8967578753736
95673,3938,16665,23.6,2212,1726,1005.1682766258537
95674,256,859,29.8,126,130,28.56066788023351
95675,108,487,22.2,28,80,2079.207920792079
95676,32,113,28.3,26,6,
95677,6753,28591,23.6,3320,3433,2763.4718222953516
95678,9489,45210,21.0,4626,4863,3770.5032822757103
95679,27,131,20.6,0,27,10.665312341289996
95680,0,9,0.0,0,0,0.0
95681,452,1370,33.0,141,311,65.52651806302843
95682,5926,29750,19.9,2549,3377,328.82747571843396
95683,1191,6330,18.8,702,489,70.4484663216035
95684,190,2913,6.5,87,103,17.877591374703552
95685,764,4703,16.2,423,341,119.96898216474474
95686,319,1194,26.7,131,188,34.975612767796505
95687,14078,68996,20.4,6851,7227,1550.2165765199632
95688,9919,40147,24.7,4739,5180,414.27360274776635
95689,272,1498,18.2,120,152,57.55224825839139
95690,407,1621,25.1,86,321,39.92712330891189
95691,10540,39961,26.4,4925,5615,1004.3558470841448
95692,1282,4887,26.2,723,559,86.04781210680834
95693,1322,7624,17.3,513,809,109.16963570344862
95694,2193,9600,22.8,1149,1044,79.50948174500287
95695,9105,39892,22.8,4552,4553,277.03760679064914
95697,142,281,50.5,59,83,686.1313868613138
95698,29,196,14.8,14,15,5.027350872623079
95699,9,60,15.0,9,0,3.723861357777141
95701,74,1045,7.1,45,29,33.50970017636684
95703,109,1955,5.6,67,42,102.50056318990764
95709,1054,6103,17.3,612,442,236.77243118302164
95713,2042,10280,19.9,911,1131,173.52311996050682
95714,72,411,17.5,29,43,123.74860956618464
95715,26,110,23.6,11,15,2.9866635124345744
95717,20,129,15.5,14,6,7.690335811330429
95720,36,107,33.6,20,16,0.6931919564059281
95721,0,0,,0,0,0.0
95722,751,4829,15.6,396,355,475.8666922045585
95726,1392,7974,17.5,591,801,57.41007596849336
95728,120,549,21.9,87,33,11.717633609602744
95735,2,51,3.9,2,0,0.7538549400342661
95736,0,131,0.0,0,0,1199.134199134199
95742,4228,14883,28.4,1766,2462,250.64430434954997
95746,5264,22743,23.1,2827,2437,1261.304347826087
95747,18839,75681,24.9,8717,10122,1627.4723970081918
95757,14596,53232,27.4,7449,7147,801.2155604136626
95758,16573,66153,25.1,7833,8740,4840.869054609512
95762,11486,45842,25.1,5592,5894,1043.4740790612675
95765,11470,43059,26.6,5566,5904,3193.739019325986
95776,6570,26352,24.9,3189,3381,275.6286705516882
95811,558,8456,6.6,293,265,2969.775474956822
95814,485,12248,4.0,235,250,8990.687679083096
95815,6669,26523,25.1,3128,3541,3392.9178100091467
95816,1293,18334,7.1,660,633,6197.508244778307
95817,2204,14513,15.2,1065,1139,6166.004415011037
95818,4402,23062,19.1,1864,2538,5555.066079295154
95819,3368,19806,17.0,1524,1844,5651.414309484193
95820,7403,36024,20.6,3853,3550,6672.678944370609
95821,8265,37436,22.1,3764,4501,5159.16171056358
95822,10545,46413,22.7,5223,5322,5373.065015479876
95823,23542,82983,28.4,11455,12087,7042.5995295757475
95824,8656,30556,28.3,4139,4517,7575.977933801404
95825,7896,37310,21.2,3514,4382,8004.295532646049
95826,8032,40205,20.0,4296,3736,3720.819889922186
95827,4839,21084,23.0,2608,2231,2384.0134153158187
95828,14928,60850,24.5,7307,7621,4768.120615980005
95829,8263,31297,26.4,4142,4121,1428.6980500295451
95830,124,746,16.6,23,101,51.49093144789425
95831,8743,44450,19.7,4214,4529,6167.405289492494
95832,3662,13116,27.9,1632,2030,1526.3917277864614
95833,9396,40908,23.0,4753,4643,4990.730441230998
95834,8742,34892,25.1,4447,4295,3118.928141308711
95835,9839,40957,24.0,4460,5379,4442.392161279424
95837,16,306,5.2,13,3,18.432218126173748
95838,11497,41311,27.8,5538,5959,4352.851711026616
95841,4743,21542,22.0,2350,2393,5146.998460749102
95842,9755,34775,28.1,4597,5158,8380.41289023162
95843,12533,47195,26.6,5888,6645,7354.304127666103
95864,5846,25728,22.7,2891,2955,3981.0509554140126
95901,9859,36119,27.3,4464,5395,175.73014850224027
95903,432,1868,23.1,223,209,78.31914685451521
95910,0,148,0.0,0,0,4.768413059984814
95912,1193,4908,24.3,550,643,33.54110622662555
95913,52,313,16.6,15,37,
95914,72,450,16.0,23,49,30.1521312074558
95915,0,0,,0,0,0.0
95916,149,965,15.4,77,72,14.24286085457165
95917,1035,4091,25.3,555,480,48.08990991660781
95918,226,1807,12.5,139,87,46.92213762390461
95919,237,1183,20.0,174,63,48.75317306256533
95920,27,164,16.5,5,22,4.400758551803008
95922,86,593,14.5,48,38,9.868738073668588
95923,0,43,0.0,0,0,2.65748031496063
95925,48,188,25.5,48,0,7.397959183673469
95926,7415,42362,17.5,3722,3693,5321.419388017485
95928,5989,38412,15.6,2956,3033,265.8692766402322
95929,0,0,,0,0,
95930,183,417,43.9,66,117,15.316995205114544
95932,2086,7789,26.8,1041,1045,53.104357460415414
95934,0,33,0.0,0,0,3.713675610435428
95935,43,465,9.2,0,43,4.377978381310294
95936,0,121,0.0,0,0,2.253585249260187
95937,218,1145,19.0,128,90,28.9822385114181
95938,957,4451,21.5,600,357,61.65901187104726
95939,37,376,9.8,15,22,2.3031165991682325
95941,85,396,21.5,2,83,23.931816899023534
95942,391,1786,21.9,101,290,23.209740860712632
95943,139,670,20.7,74,65,11.496060515514175
95944,0,65,0.0,0,0,8.505209440782478
95945,5055,27388,18.5,2294,2761,429.8284349802921
95946,1327,9049,14.7,609,718,186.37776436126205
95947,306,1407,21.7,134,172,19.62184627992741
95948,3520,11456,30.7,1813,1707,160.41606013286398
95949,3101,21232,14.6,1569,1532,151.6233623975814
95950,99,442,22.4,35,64,9.345971205327585
95951,599,2522,23.8,328,271,133.01650569778732
95953,3175,11201,28.3,1622,1553,95.32787520338852
95954,2033,10163,20.0,1036,997,96.35656897761588
95955,354,1413,25.1,137,217,11.555528400021386
95956,99,458,21.6,69,30,6.739068015606263
95957,167,752,22.2,100,67,7.774109955806926
95958,0,0,,0,0,
95959,2483,18244,13.6,1092,1391,57.191774233884146
95960,160,594,26.9,66,94,14.230427153193434
95961,9661,32663,29.6,4947,4714,630.97626941197
95962,132,1136,11.6,21,111,27.747035573122528
95963,4389,16485,26.6,2219,2170,48.883192406876354
95965,4927,20835,23.6,2585,2342,66.40849525240752
95966,6423,30108,21.3,3136,3287,173.03510772087773
95968,208,1366,15.2,66,142,651.8353726362625
95969,1048,7564,13.9,369,679,376.96995995976255
95970,135,466,29.0,53,82,16.60332689552053
95971,983,5931,16.6,394,589,39.43198843823338
95972,86,142,60.6,47,39,
95973,8474,38323,22.1,3760,4714,120.70511004848464
95974,0,65,0.0,0,0,0.0
95975,408,1628,25.1,226,182,183.9177879012607
95977,332,1822,18.2,149,183,42.11253020365896
95978,23,98,23.5,12,11,4135.135135135135
95979,35,374,9.4,9,26,1.6950817012301085
95981,0,52,0.0,0,0,0.6592827004219409
95982,729,3084,23.6,400,329,72.74221961244862
95983,10,395,2.5,0,10,3.5861196076363258
95984,0,177,0.0,0,0,4.009633707389371
95986,0,104,0.0,0,0,11.302030690067078
95987,1916,6504,29.5,1016,900,19.05513053079896
95988,2486,8748,28.4,911,1575,25.743393746120233
95991,12091,43978,27.5,5897,6194,990.977626459144
95993,8360,37222,22.5,3603,4757,447.4620915497971
96001,8049,34721,23.2,3472,4577,469.0693921463152
96002,8629,34634,24.9,4231,4398,1111.35485560867
96003,8476,43945,19.3,4290,4186,397.39633471583704
96006,56,587,9.5,40,16,3.0472849434394185
96007,5081,24849,20.4,2549,2532,193.23079937304075
96008,205,1123,18.3,74,131,21.727172717271728
96009,59,247,23.9,31,28,1.4339072247243054
96010,0,28,0.0,0,0,0.2501009522072711
96011,70,232,30.2,29,41,2.241186104646151
96013,1177,4212,27.9,628,549,31.82994478811543
96014,40,173,23.1,29,11,1.0340860618124943
96015,6,560,1.1,3,3,1.426417769578011
96016,57,319,17.9,0,57,8.57383808095952
96017,10,143,7.0,5,5,2.162625127134522
96019,2433,10466,23.2,1198,1235,528.8058388115327
96020,362,2593,14.0,107,255,42.92615351827514
96021,3780,15746,24.0,2154,1626,59.976201827731686
96022,2887,14751,19.6,1604,1283,58.83110195674563
96023,279,1189,23.5,117,162,5.537067591375598
96024,315,1105,28.5,113,202,7.884475706257885
96025,451,2247,20.1,251,200,21.56605086186906
96027,345,1907,18.1,167,178,5.422388045459317
96028,395,1805,21.9,190,205,5.945833457204864
96029,42,120,35.0,20,22,7.793592846302145
96031,3,66,4.5,3,0,0.3048296446829454
96032,587,2606,22.5,269,318,5.257425247187509
96033,60,321,18.7,20,40,3.343742227871888
96034,54,345,15.7,21,33,2.928466840469983
96035,1219,4097,29.8,310,909,78.54707887621959
96037,0,131,0.0,0,0,68.56309263311452
96038,87,499,17.4,31,56,39.24036777583188
96039,112,726,15.4,57,55,3.3918837068443364
96040,0,71,0.0,0,0,1.3202089036441649
96041,389,3511,11.1,65,324,8.556305916993999
96044,309,1215,25.4,182,127,5.099427504272187
96046,0,328,0.0,0,0,0.878386036495523
96047,66,843,7.8,35,31,3.781944136778299
96048,143,1283,11.1,70,73,5.115303443660885
96050,9,400,2.3,3,6,1.6005381519583397
96051,59,1067,5.5,45,14,3.4737589974143352
96052,611,2538,24.1,359,252,15.507780876135648
96054,40,269,14.9,9,31,2.249881138354955
96055,918,3760,24.4,371,547,44.047218954797515
96056,267,1318,20.3,126,141,8.006256912916916
96057,148,1158,12.8,33,115,10.22189682360892
96058,190,809,23.5,94,96,1.3902294564120563
96059,52,323,16.1,0,52,7.523649127225221
96061,0,0,,0,0,0.0
96062,95,1002,9.5,47,48,18.13089403036217
96063,0,77,0.0,0,0,19.284171551990127
96064,1011,4690,21.6,443,568,8.969015009958728
96065,29,364,8.0,17,12,2.085840352988367
96067,1226,7321,16.7,813,413,92.30648371216088
96068,23,125,18.4,15,8,6.980315510261064
96069,330,1390,23.7,141,189,12.566628977548056
96071,0,7,0.0,0,0,0.8144585789636984
96073,1611,5648,28.5,825,786,100.34051209481272
96074,29,183,15.8,6,23,1.201883318080074
96075,0,341,0.0,0,0,3.892423557432545
96076,0,152,0.0,0,0,0.9079821113972084
96078,37,135,27.4,37,0,
96080,7782,31190,25.0,3818,3964,47.88701943494275
96084,99,664,14.9,61,38,9.47203538192205
96085,9,38,23.7,9,0,1.1934468916133232
96086,42,268,15.7,21,21,1.176545877905059
96087,106,824,12.9,31,75,16.363125614495058
96088,488,4703,10.4,295,193,29.02621722846442
96090,79,421,18.8,30,49,164.4865925441465
96091,41,693,5.9,21,20,1.5935880410384178
96092,83,402,20.6,51,32,4.81036633946154
96093,696,3959,17.6,463,233,34.829317269076306
96094,1222,6985,17.5,556,666,35.443442164923766
96096,78,784,9.9,47,31,6.930167462960282
96097,2494,10154,24.6,1013,1481,52.10270859243443
96101,927,4824,19.2,498,429,8.63610838718329
96103,214,1340,16.0,133,81,13.805935627126658
96104,240,962,24.9,145,95,3.863890265516459
96105,103,429,24.0,69,34,1.3813513630514092
96106,155,465,33.3,92,63,21.078875793291022
96107,157,868,18.1,103,54,11.041124795002768
96108,51,149,34.2,26,25,0.8430623439267496
96109,216,1297,16.7,47,169,4.270389474471107
96110,0,37,0.0,0,0,0.7376319470939845
96111,0,23,0.0,0,0,23.255813953488374
96112,29,172,16.9,15,14,1.6458583151113304
96113,163,2164,7.5,77,86,87.67674918775454
96114,401,2927,13.7,213,188,47.736738523502225
96115,17,122,13.9,12,5,1.4917240578467366
96116,0,19,0.0,0,0,0.8443696412279061
96117,127,288,44.1,83,44,0.9373111503027762
96118,233,1581,14.7,72,161,9.78841557711233
96119,15,31,48.4,15,0,0.0825565512375977
96120,245,1209,20.3,103,142,4.093257385084117
96121,0,145,0.0,0,0,8.97536292994398
96122,777,4121,18.9,364,413,56.12818590704648
96123,17,62,27.4,0,17,0.133837354898001
96124,122,320,38.1,77,45,6.910446637041501
96125,0,234,0.0,0,0,0.9054944107279528
96126,41,227,18.1,41,0,5.77893820713664
96128,225,600,37.5,78,147,36.36443973135383
96129,217,640,33.9,0,217,2.5948052171964036
96130,3690,21460,17.2,1871,1819,39.72721671427771
96132,0,17,0.0,0,0,0.4421916327516603
96133,0,188,0.0,0,0,10.421455938697315
96134,535,2236,23.9,300,235,6.2953569088128924
96135,0,106,0.0,0,0,8.039970137253777
96136,16,40,40.0,16,0,0.1657332661192865
96137,455,2949,15.4,216,239,21.633786967682948
96140,190,1219,15.6,160,30,130.02706883217326
96141,67,592,11.3,41,26,16.039631400263286
96142,119,946,12.6,61,58,58.42612285750031
96143,675,3130,21.6,405,270,363.6363636363637
96145,597,3081,19.4,346,251,150.42348955392433
96146,97,1147,8.5,40,57,27.109253258799377
96148,69,630,11.0,26,43,325.03590234561995
96150,4779,29457,16.2,2537,2242,186.12219382595745
96155,0,0,,0,0,0.0
96161,4062,19146,21.2,2106,1956,71.51179171648099
97635,123,345,35.7,107,16,3.144533496951336
